,idSolicitudLista,txOrganizacionPolitica,numLista,numCandidatos,txDescUbigeo,idOrganizacionPolitica,txDepartamento,txProvincia,txDistrito,idTipoEleccion,numTotalCandidatoHombre,numTotalCandidatoMujer,fgTieneAccesitario,numTotalAccesitarios,numTotalObligatorios,txTipoEleccion
0,53,NUEVA LIBERTAD,1,10,SANTIAGO DE CHUCO - LA LIBERTAD,2232,LA LIBERTAD,SANTIAGO DE CHUCO,,5,6,4,NO,0,10,MUNICIPAL PROVINCIAL
1,64,MOVIMIENTO REGIONAL SOMOS CALLAO,1,19,CALLAO - CALLAO,2896,CALLAO,CALLAO,,5,10,9,SI,3,16,MUNICIPAL PROVINCIAL
2,131,RENOVACION POPULAR,1,19,TRUJILLO - LA LIBERTAD,22,LA LIBERTAD,TRUJILLO,,5,10,9,SI,3,16,MUNICIPAL PROVINCIAL
3,194,SOCIOS POR ANCASH,1,13,CASMA - ANCASH,2881,ANCASH,CASMA,,5,7,6,SI,3,10,MUNICIPAL PROVINCIAL
4,562,CONTIGO CALLAO,1,20,CALLAO - CALLAO,2652,CALLAO,CALLAO,,5,11,9,SI,4,16,MUNICIPAL PROVINCIAL
5,639,MOVIMIENTO INDEPENDIENTE REGIONAL CAMBIO UCAYALINO,1,12,PADRE ABAD - UCAYALI,2278,UCAYALI,PADRE ABAD,,5,6,6,SI,2,10,MUNICIPAL PROVINCIAL
6,674,MOVIMIENTO INDEPENDIENTE REGIONAL CAMBIO UCAYALINO,1,8,PURUS - UCAYALI,2278,UCAYALI,PURUS,,5,5,3,SI,2,6,MUNICIPAL PROVINCIAL
7,681,CONTIGO REGION,1,19,SULLANA - PIURA,2862,PIURA,SULLANA,,5,10,9,SI,5,14,MUNICIPAL PROVINCIAL
8,142,"AREQUIPA, TRADICION Y FUTURO",1,11,CARAVELI - AREQUIPA,142,AREQUIPA,CARAVELI,,5,6,5,SI,3,8,MUNICIPAL PROVINCIAL
9,796,UNION REGIONAL,1,19,TOCACHE - SAN MARTIN,2722,SAN MARTIN,TOCACHE,,5,10,9,SI,9,10,MUNICIPAL PROVINCIAL
10,794,UNION REGIONAL,1,14,HUALLAGA - SAN MARTIN,2722,SAN MARTIN,HUALLAGA,,5,8,6,SI,6,8,MUNICIPAL PROVINCIAL
11,862,SOCIOS POR ANCASH,1,19,SANTA - ANCASH,2881,ANCASH,SANTA,,5,10,9,SI,5,14,MUNICIPAL PROVINCIAL
12,867,UNION REGIONAL,1,10,EL DORADO - SAN MARTIN,2722,SAN MARTIN,EL DORADO,,5,6,4,SI,2,8,MUNICIPAL PROVINCIAL
13,880,CONTIGO REGION,1,16,AYABACA - PIURA,2862,PIURA,AYABACA,,5,8,8,SI,4,12,MUNICIPAL PROVINCIAL
14,933,MOVIMIENTO REGIONAL REVALORA,1,12,ISLAY - AREQUIPA,2719,AREQUIPA,ISLAY,,5,6,6,SI,2,10,MUNICIPAL PROVINCIAL
15,976,JUNTOS POR EL PERU,1,10,RECUAY - ANCASH,1264,ANCASH,RECUAY,,5,5,5,SI,4,6,MUNICIPAL PROVINCIAL
16,1058,MOVIMIENTO INDEPENDIENTE REGIONAL CAMBIO UCAYALINO,1,17,CORONEL PORTILLO - UCAYALI,2278,UCAYALI,CORONEL PORTILLO,,5,9,8,SI,3,14,MUNICIPAL PROVINCIAL
17,1075,AREQUIPA TRANSFORMACION,1,21,AREQUIPA - AREQUIPA,2313,AREQUIPA,AREQUIPA,,5,11,10,SI,5,16,MUNICIPAL PROVINCIAL
18,1106,AVANZA PAIS - PARTIDO DE INTEGRACION SOCIAL,1,9,HUARMEY - ANCASH,2173,ANCASH,HUARMEY,,5,5,4,SI,1,8,MUNICIPAL PROVINCIAL
19,1096,MOVIMIENTO REGIONAL WARI LLAQTA,1,15,LA MAR - AYACUCHO,2706,AYACUCHO,LA MAR,,5,8,7,SI,5,10,MUNICIPAL PROVINCIAL
20,1167,AVANZA PAIS - PARTIDO DE INTEGRACION SOCIAL,1,18,CAJAMARCA - CAJAMARCA,2173,CAJAMARCA,CAJAMARCA,,5,10,8,SI,4,14,MUNICIPAL PROVINCIAL
21,1119,MOVIMIENTO REGIONAL EL MAICITO,1,15,PALLASCA - ANCASH,2245,ANCASH,PALLASCA,,5,8,7,SI,7,8,MUNICIPAL PROVINCIAL
22,1228,MOVIMIENTO INDEPENDIENTE REGIONAL MI BUEN VECINO,1,11,PUERTO INCA - HUANUCO,2730,HUANUCO,PUERTO INCA,,5,5,6,SI,3,8,MUNICIPAL PROVINCIAL
23,931,PARTIDO POLITICO NACIONAL PERU LIBRE,1,17,CORONEL PORTILLO - UCAYALI,2218,UCAYALI,CORONEL PORTILLO,,5,9,8,SI,3,14,MUNICIPAL PROVINCIAL
24,1319,MOVIMIENTO REGIONAL FORTALEZA PERU,1,13,VIRU - LA LIBERTAD,2738,LA LIBERTAD,VIRU,,5,7,6,SI,3,10,MUNICIPAL PROVINCIAL
25,1349,MOVIMIENTO INDEPENDIENTE REGIONAL MI BUEN VECINO,1,7,HUACAYBAMBA - HUANUCO,2730,HUANUCO,HUACAYBAMBA,,5,4,3,SI,1,6,MUNICIPAL PROVINCIAL
26,1344,MOVIMIENTO REGIONAL UNIDAD CIVICA LIMA,1,12,HUAROCHIRI - LIMA,2306,LIMA,HUAROCHIRI,,5,6,6,SI,2,10,MUNICIPAL PROVINCIAL
27,1399,AVANZA PAIS - PARTIDO DE INTEGRACION SOCIAL,1,16,SAN IGNACIO - CAJAMARCA,2173,CAJAMARCA,SAN IGNACIO,,5,8,8,SI,4,12,MUNICIPAL PROVINCIAL
28,1417,MOVIMIENTO REGIONAL UNIDAD CIVICA LIMA,1,7,CANTA - LIMA,2306,LIMA,CANTA,,5,4,3,SI,1,6,MUNICIPAL PROVINCIAL
29,1457,MOVIMIENTO REGIONAL FORTALEZA PERU,1,14,GRAN CHIMU - LA LIBERTAD,2738,LA LIBERTAD,GRAN CHIMU,,5,8,6,SI,6,8,MUNICIPAL PROVINCIAL
30,1462,SIEMPRE TACNA,1,7,CANDARAVE - TACNA,2178,TACNA,CANDARAVE,,5,4,3,SI,1,6,MUNICIPAL PROVINCIAL
31,1445,SIEMPRE TACNA,1,23,TACNA - TACNA,2178,TACNA,TACNA,,5,12,11,SI,9,14,MUNICIPAL PROVINCIAL
32,1464,SIEMPRE TACNA,1,11,TARATA - TACNA,2178,TACNA,TARATA,,5,6,5,SI,5,6,MUNICIPAL PROVINCIAL
33,1578,RENOVACION POPULAR,1,13,ZARUMILLA - TUMBES,22,TUMBES,ZARUMILLA,,5,7,6,SI,3,10,MUNICIPAL PROVINCIAL
34,1350,MOVIMIENTO REGIONAL AREQUIPA AVANCEMOS,1,12,ISLAY - AREQUIPA,2307,AREQUIPA,ISLAY,,5,6,6,SI,2,10,MUNICIPAL PROVINCIAL
35,1753,RENOVACION POPULAR,1,12,TARMA - JUNIN,22,JUNIN,TARMA,,5,6,6,SI,2,10,MUNICIPAL PROVINCIAL
36,1775,MOVIMIENTO ESPERANZA REGION AMAZONICA,1,10,MARISCAL RAMON CASTILLA - LORETO,150,LORETO,MARISCAL RAMON CASTILLA,,5,6,4,NO,0,10,MUNICIPAL PROVINCIAL
37,1792,MOVIMIENTO ESPERANZA REGION AMAZONICA,1,10,UCAYALI - LORETO,150,LORETO,UCAYALI,,5,5,5,NO,0,10,MUNICIPAL PROVINCIAL
38,1811,UNION REGIONAL,1,18,MOYOBAMBA - SAN MARTIN,2722,SAN MARTIN,MOYOBAMBA,,5,10,8,SI,6,12,MUNICIPAL PROVINCIAL
39,1824,UCAYALI REGION CON FUTURO,1,10,ATALAYA - UCAYALI,233,UCAYALI,ATALAYA,,5,6,4,NO,0,10,MUNICIPAL PROVINCIAL
40,1825,MOVIMIENTO ESPERANZA REGION AMAZONICA,1,10,DATEM DEL MARAÑON - LORETO,150,LORETO,DATEM DEL MARAÑON,,5,5,5,NO,0,10,MUNICIPAL PROVINCIAL
41,1878,MOVIMIENTO ESPERANZA REGION AMAZONICA,1,6,PUTUMAYO - LORETO,150,LORETO,PUTUMAYO,,5,4,2,NO,0,6,MUNICIPAL PROVINCIAL
42,1877,UNION REGIONAL,1,21,SAN MARTIN - SAN MARTIN,2722,SAN MARTIN,SAN MARTIN,,5,10,11,SI,9,12,MUNICIPAL PROVINCIAL
43,1883,TRABAJO MAS TRABAJO,1,30,TRUJILLO - LA LIBERTAD,2884,LA LIBERTAD,TRUJILLO,,5,16,14,SI,14,16,MUNICIPAL PROVINCIAL
44,1858,PARTIDO DEMOCRATICO SOMOS PERU,1,8,PURUS - UCAYALI,14,UCAYALI,PURUS,,5,4,4,SI,2,6,MUNICIPAL PROVINCIAL
45,1954,PARTIDO DEMOCRATICO SOMOS PERU,1,10,ATALAYA - UCAYALI,14,UCAYALI,ATALAYA,,5,5,5,NO,0,10,MUNICIPAL PROVINCIAL
46,1924,UCAYALI REGION CON FUTURO,1,12,PADRE ABAD - UCAYALI,233,UCAYALI,PADRE ABAD,,5,6,6,SI,2,10,MUNICIPAL PROVINCIAL
47,1963,MOVIMIENTO REGIONAL FORTALEZA PERU,1,8,BOLIVAR - LA LIBERTAD,2738,LA LIBERTAD,BOLIVAR,,5,5,3,SI,2,6,MUNICIPAL PROVINCIAL
48,1966,ALIANZA GOBIERNO UNIDAD Y ACCION,1,8,CARLOS FERMIN FITZCARRALD - ANCASH,2856,ANCASH,CARLOS FERMIN FITZCARRALD,,5,5,3,SI,2,6,MUNICIPAL PROVINCIAL
49,1982,AVANZA PAIS - PARTIDO DE INTEGRACION SOCIAL,1,8,YAROWILCA - HUANUCO,2173,HUANUCO,YAROWILCA,,5,4,4,SI,2,6,MUNICIPAL PROVINCIAL
50,1960,"UNIDAD, EXPERIENCIA Y TRABAJO CON ETICA",1,16,ZARUMILLA - TUMBES,2759,TUMBES,ZARUMILLA,,5,8,8,SI,6,10,MUNICIPAL PROVINCIAL
51,2071,MOVIMIENTO REGIONAL REVALORA,1,8,CASTILLA - AREQUIPA,2719,AREQUIPA,CASTILLA,,5,4,4,NO,0,8,MUNICIPAL PROVINCIAL
52,2061,PARTIDO DEMOCRATICO SOMOS PERU,1,20,CORONEL PORTILLO - UCAYALI,14,UCAYALI,CORONEL PORTILLO,,5,11,9,SI,6,14,MUNICIPAL PROVINCIAL
53,2133,AVANZA PAIS - PARTIDO DE INTEGRACION SOCIAL,1,10,ISLAY - AREQUIPA,2173,AREQUIPA,ISLAY,,5,5,5,NO,0,10,MUNICIPAL PROVINCIAL
54,517,TRABAJO MAS TRABAJO,1,14,CHEPEN - LA LIBERTAD,2884,LA LIBERTAD,CHEPEN,,5,8,6,SI,4,10,MUNICIPAL PROVINCIAL
55,1785,"AREQUIPA, TRADICION Y FUTURO",1,12,CAMANA - AREQUIPA,142,AREQUIPA,CAMANA,,5,6,6,SI,2,10,MUNICIPAL PROVINCIAL
56,2283,PARTIDO DEMOCRATICO SOMOS PERU,1,10,SAN MARCOS - CAJAMARCA,14,CAJAMARCA,SAN MARCOS,,5,6,4,NO,0,10,MUNICIPAL PROVINCIAL
57,2308,FUERZA AREQUIPEÑA,1,10,CASTILLA - AREQUIPA,1393,AREQUIPA,CASTILLA,,5,5,5,SI,2,8,MUNICIPAL PROVINCIAL
58,1754,PARTIDO POLITICO NACIONAL PERU LIBRE,1,18,ATALAYA - UCAYALI,2218,UCAYALI,ATALAYA,,5,10,8,SI,8,10,MUNICIPAL PROVINCIAL
59,2272,MOVIMIENTO ESPERANZA REGION AMAZONICA,1,10,REQUENA - LORETO,150,LORETO,REQUENA,,5,5,5,NO,0,10,MUNICIPAL PROVINCIAL
60,1374,RENOVACION POPULAR,1,16,UTCUBAMBA - AMAZONAS,22,AMAZONAS,UTCUBAMBA,,5,9,7,SI,4,12,MUNICIPAL PROVINCIAL
61,1791,UCAYALI REGION CON FUTURO,1,18,CORONEL PORTILLO - UCAYALI,233,UCAYALI,CORONEL PORTILLO,,5,9,9,SI,4,14,MUNICIPAL PROVINCIAL
62,1238,PARTIDO POLITICO NACIONAL PERU LIBRE,1,14,PADRE ABAD - UCAYALI,2218,UCAYALI,PADRE ABAD,,5,8,6,SI,4,10,MUNICIPAL PROVINCIAL
63,2400,ACCION POPULAR,1,14,TACNA - TACNA,4,TACNA,TACNA,,5,7,7,NO,0,14,MUNICIPAL PROVINCIAL
64,2430,AVANZA PAIS - PARTIDO DE INTEGRACION SOCIAL,1,12,VIRU - LA LIBERTAD,2173,LA LIBERTAD,VIRU,,5,6,6,SI,2,10,MUNICIPAL PROVINCIAL
65,1455,RENOVACION POPULAR,1,13,CONDORCANQUI - AMAZONAS,22,AMAZONAS,CONDORCANQUI,,5,7,6,SI,5,8,MUNICIPAL PROVINCIAL
66,2463,ACCION POPULAR,1,6,TARATA - TACNA,4,TACNA,TARATA,,5,3,3,NO,0,6,MUNICIPAL PROVINCIAL
67,1379,RENOVACION POPULAR,1,11,RODRIGUEZ DE MENDOZA - AMAZONAS,22,AMAZONAS,RODRIGUEZ DE MENDOZA,,5,6,5,SI,3,8,MUNICIPAL PROVINCIAL
68,2484,PARTIDO DEMOCRATICO SOMOS PERU,1,6,SAN PABLO - CAJAMARCA,14,CAJAMARCA,SAN PABLO,,5,4,2,NO,0,6,MUNICIPAL PROVINCIAL
69,1538,UNION REGIONAL,1,16,MARISCAL CACERES - SAN MARTIN,2722,SAN MARTIN,MARISCAL CACERES,,5,9,7,SI,6,10,MUNICIPAL PROVINCIAL
70,2482,PARTIDO DEMOCRATICO SOMOS PERU,1,10,CAJABAMBA - CAJAMARCA,14,CAJAMARCA,CAJABAMBA,,5,5,5,NO,0,10,MUNICIPAL PROVINCIAL
71,2518,UNION REGIONAL,1,18,BELLAVISTA - SAN MARTIN,2722,SAN MARTIN,BELLAVISTA,,5,10,8,SI,8,10,MUNICIPAL PROVINCIAL
72,2532,ALIANZA GOBIERNO UNIDAD Y ACCION,1,6,CORONGO - ANCASH,2856,ANCASH,CORONGO,,5,4,2,NO,0,6,MUNICIPAL PROVINCIAL
73,2546,FRENTE POPULAR AGRICOLA FIA DEL PERU,1,12,BAGUA - AMAZONAS,2901,AMAZONAS,BAGUA,,5,6,6,SI,2,10,MUNICIPAL PROVINCIAL
74,2560,FRENTE POPULAR AGRICOLA FIA DEL PERU,1,12,LUCANAS - AYACUCHO,2901,AYACUCHO,LUCANAS,,5,6,6,SI,2,10,MUNICIPAL PROVINCIAL
75,2499,TRABAJO MAS TRABAJO,1,8,GRAN CHIMU - LA LIBERTAD,2884,LA LIBERTAD,GRAN CHIMU,,5,5,3,NO,0,8,MUNICIPAL PROVINCIAL
76,1684,ACCION POPULAR,1,14,PAITA - PIURA,4,PIURA,PAITA,,5,8,6,SI,2,12,MUNICIPAL PROVINCIAL
77,2585,FRENTE POPULAR AGRICOLA FIA DEL PERU,1,15,CUTERVO - CAJAMARCA,2901,CAJAMARCA,CUTERVO,,5,8,7,SI,3,12,MUNICIPAL PROVINCIAL
78,2596,FRENTE POPULAR AGRICOLA FIA DEL PERU,1,18,CHOTA - CAJAMARCA,2901,CAJAMARCA,CHOTA,,5,9,9,SI,6,12,MUNICIPAL PROVINCIAL
79,2592,FRENTE POPULAR AGRICOLA FIA DEL PERU,1,15,CELENDIN - CAJAMARCA,2901,CAJAMARCA,CELENDIN,,5,8,7,SI,5,10,MUNICIPAL PROVINCIAL
80,2606,FRENTE POPULAR AGRICOLA FIA DEL PERU,1,15,HUALGAYOC - CAJAMARCA,2901,CAJAMARCA,HUALGAYOC,,5,8,7,SI,5,10,MUNICIPAL PROVINCIAL
81,2603,AVANZA PAIS - PARTIDO DE INTEGRACION SOCIAL,1,18,CALLAO - CALLAO,2173,CALLAO,CALLAO,,5,9,9,SI,2,16,MUNICIPAL PROVINCIAL
82,2726,AVANZA PAIS - PARTIDO DE INTEGRACION SOCIAL,1,9,PUERTO INCA - HUANUCO,2173,HUANUCO,PUERTO INCA,,5,5,4,SI,1,8,MUNICIPAL PROVINCIAL
83,2837,FRENTE ESPERANZA POR TACNA,1,19,TACNA - TACNA,2708,TACNA,TACNA,,5,10,9,SI,5,14,MUNICIPAL PROVINCIAL
84,156,CAMINEMOS JUNTOS POR JUNIN,1,13,TARMA - JUNIN,122,JUNIN,TARMA,,5,7,6,SI,3,10,MUNICIPAL PROVINCIAL
85,2958,JUNTOS POR LORETO,1,13,UCAYALI - LORETO,2871,LORETO,UCAYALI,,5,7,6,SI,3,10,MUNICIPAL PROVINCIAL
86,2969,AVANZA PAIS - PARTIDO DE INTEGRACION SOCIAL,1,15,JAEN - CAJAMARCA,2173,CAJAMARCA,JAEN,,5,8,7,SI,3,12,MUNICIPAL PROVINCIAL
87,3132,AVANZA PAIS - PARTIDO DE INTEGRACION SOCIAL,1,16,CHOTA - CAJAMARCA,2173,CAJAMARCA,CHOTA,,5,9,7,SI,4,12,MUNICIPAL PROVINCIAL
88,305,ORGANIZACION POLITICA UNIDAD REGIONAL,1,16,MORROPON - PIURA,2711,PIURA,MORROPON,,5,9,7,SI,4,12,MUNICIPAL PROVINCIAL
89,3356,PARTIDO DEMOCRATICO SOMOS PERU,1,12,LAMAS - SAN MARTIN,14,SAN MARTIN,LAMAS,,5,6,6,SI,2,10,MUNICIPAL PROVINCIAL
90,3349,PARTIDO DEMOCRATICO SOMOS PERU,1,11,CHURCAMPA - HUANCAVELICA,14,HUANCAVELICA,CHURCAMPA,,5,6,5,SI,3,8,MUNICIPAL PROVINCIAL
91,3375,PARTIDO DEMOCRATICO SOMOS PERU,1,15,SAN MARTIN - SAN MARTIN,14,SAN MARTIN,SAN MARTIN,,5,7,8,SI,3,12,MUNICIPAL PROVINCIAL
92,3389,MOVIMIENTO REGIONAL WARI LLAQTA,1,12,SUCRE - AYACUCHO,2706,AYACUCHO,SUCRE,,5,7,5,SI,6,6,MUNICIPAL PROVINCIAL
93,3436,FUERZA AREQUIPEÑA,1,8,CONDESUYOS - AREQUIPA,1393,AREQUIPA,CONDESUYOS,,5,4,4,SI,2,6,MUNICIPAL PROVINCIAL
94,3426,PARTIDO DEMOCRATICO SOMOS PERU,1,10,HUALGAYOC - CAJAMARCA,14,CAJAMARCA,HUALGAYOC,,5,6,4,NO,0,10,MUNICIPAL PROVINCIAL
95,3467,MORAL Y DESARROLLO,1,14,CARABAYA - PUNO,292,PUNO,CARABAYA,,5,8,6,SI,4,10,MUNICIPAL PROVINCIAL
96,3485,MOVIMIENTO ESPERANZA REGION AMAZONICA,1,10,LORETO - LORETO,150,LORETO,LORETO,,5,5,5,NO,0,10,MUNICIPAL PROVINCIAL
97,3545,PARTIDO DEMOCRATICO SOMOS PERU,1,13,PICOTA - SAN MARTIN,14,SAN MARTIN,PICOTA,,5,7,6,SI,5,8,MUNICIPAL PROVINCIAL
98,3635,PARTIDO DEMOCRATICO SOMOS PERU,1,12,SAN IGNACIO - CAJAMARCA,14,CAJAMARCA,SAN IGNACIO,,5,7,5,NO,0,12,MUNICIPAL PROVINCIAL
99,2536,PARTIDO DEMOCRATICO SOMOS PERU,1,8,SAN MIGUEL - CAJAMARCA,14,CAJAMARCA,SAN MIGUEL,,5,5,3,NO,0,8,MUNICIPAL PROVINCIAL
100,3674,ALIANZA GOBIERNO UNIDAD Y ACCION,1,10,ANTONIO RAIMONDI - ANCASH,2856,ANCASH,ANTONIO RAIMONDI,,5,5,5,SI,4,6,MUNICIPAL PROVINCIAL
101,3687,ALIANZA GOBIERNO UNIDAD Y ACCION,1,15,POMABAMBA - ANCASH,2856,ANCASH,POMABAMBA,,5,8,7,SI,7,8,MUNICIPAL PROVINCIAL
102,3692,AVANZA PAIS - PARTIDO DE INTEGRACION SOCIAL,1,16,CELENDIN - CAJAMARCA,2173,CAJAMARCA,CELENDIN,,5,9,7,SI,6,10,MUNICIPAL PROVINCIAL
103,3734,MOVIMIENTO POLITICO CAMBIEMOS X HCO,1,8,YAROWILCA - HUANUCO,2733,HUANUCO,YAROWILCA,,5,5,3,SI,2,6,MUNICIPAL PROVINCIAL
104,2656,PARTIDO DEMOCRATICO SOMOS PERU,1,12,CHOTA - CAJAMARCA,14,CAJAMARCA,CHOTA,,5,7,5,NO,0,12,MUNICIPAL PROVINCIAL
105,3795,AVANZA PAIS - PARTIDO DE INTEGRACION SOCIAL,1,15,TAMBOPATA - MADRE DE DIOS,2173,MADRE DE DIOS,TAMBOPATA,,5,8,7,SI,3,12,MUNICIPAL PROVINCIAL
106,3890,MOVIMIENTO DE INCLUSION REGIONAL,1,16,TUMBES - TUMBES,2647,TUMBES,TUMBES,,5,8,8,SI,4,12,MUNICIPAL PROVINCIAL
107,3922,MOVIMIENTO INDEPENDIENTE POLITICO VOLUNTAD GENERAL AMAZONICA - VOGA ,1,13,REQUENA - LORETO,2333,LORETO,REQUENA,,5,7,6,SI,3,10,MUNICIPAL PROVINCIAL
108,3972,MOVIMIENTO DE INCLUSION REGIONAL,1,14,ZARUMILLA - TUMBES,2647,TUMBES,ZARUMILLA,,5,7,7,SI,4,10,MUNICIPAL PROVINCIAL
109,3981,AVANZA PAIS - PARTIDO DE INTEGRACION SOCIAL,1,10,SAN MIGUEL - CAJAMARCA,2173,CAJAMARCA,SAN MIGUEL,,5,6,4,SI,2,8,MUNICIPAL PROVINCIAL
110,3974,PARTIDO DEMOCRATICO SOMOS PERU,1,13,ESPINAR - CUSCO,14,CUSCO,ESPINAR,,5,7,6,SI,3,10,MUNICIPAL PROVINCIAL
111,3877,FRENTE POPULAR AGRICOLA FIA DEL PERU,1,18,TRUJILLO - LA LIBERTAD,2901,LA LIBERTAD,TRUJILLO,,5,8,10,SI,2,16,MUNICIPAL PROVINCIAL
112,3949,PARTIDO DEMOCRATICO SOMOS PERU,1,12,CAYLLOMA - AREQUIPA,14,AREQUIPA,CAYLLOMA,,5,7,5,SI,2,10,MUNICIPAL PROVINCIAL
113,3896,MOVIMIENTO REGIONAL GANA AYACUCHO,1,10,VICTOR FAJARDO - AYACUCHO,2694,AYACUCHO,VICTOR FAJARDO,,5,5,5,SI,4,6,MUNICIPAL PROVINCIAL
114,4005,PARTIDO POLITICO NACIONAL PERU LIBRE,1,19,CALLAO - CALLAO,2218,CALLAO,CALLAO,,5,10,9,SI,3,16,MUNICIPAL PROVINCIAL
115,4006,MOVIMIENTO REGIONAL GANA AYACUCHO,1,9,SUCRE - AYACUCHO,2694,AYACUCHO,SUCRE,,5,5,4,SI,3,6,MUNICIPAL PROVINCIAL
116,4074,AVANZA PAIS - PARTIDO DE INTEGRACION SOCIAL,1,10,MARAÑON - HUANUCO,2173,HUANUCO,MARAÑON,,5,6,4,SI,2,8,MUNICIPAL PROVINCIAL
117,3940,MOVIMIENTO POLITICO CAMBIEMOS X HCO,1,10,MARAÑON - HUANUCO,2733,HUANUCO,MARAÑON,,5,5,5,SI,2,8,MUNICIPAL PROVINCIAL
118,4093,AVANZA PAIS - PARTIDO DE INTEGRACION SOCIAL,1,6,SAN PABLO - CAJAMARCA,2173,CAJAMARCA,SAN PABLO,,5,4,2,NO,0,6,MUNICIPAL PROVINCIAL
119,3997,PARTIDO POLITICO NACIONAL PERU LIBRE,1,13,TUMBES - TUMBES,2218,TUMBES,TUMBES,,5,7,6,SI,1,12,MUNICIPAL PROVINCIAL
120,1112,TRABAJO MAS TRABAJO,1,14,SANCHEZ CARRION - LA LIBERTAD,2884,LA LIBERTAD,SANCHEZ CARRION,,5,8,6,SI,2,12,MUNICIPAL PROVINCIAL
121,4182,AVANZA PAIS - PARTIDO DE INTEGRACION SOCIAL,1,14,HUALGAYOC - CAJAMARCA,2173,CAJAMARCA,HUALGAYOC,,5,8,6,SI,4,10,MUNICIPAL PROVINCIAL
122,4162,PARTIDO DEMOCRATICO SOMOS PERU,1,6,CONDESUYOS - AREQUIPA,14,AREQUIPA,CONDESUYOS,,5,2,4,NO,0,6,MUNICIPAL PROVINCIAL
123,4257,PARTIDO DEMOCRATICO SOMOS PERU,1,10,ISLAY - AREQUIPA,14,AREQUIPA,ISLAY,,5,6,4,NO,0,10,MUNICIPAL PROVINCIAL
124,4244,PARTIDO POLITICO NACIONAL PERU LIBRE,1,10,VICTOR FAJARDO - AYACUCHO,2218,AYACUCHO,VICTOR FAJARDO,,5,5,5,SI,4,6,MUNICIPAL PROVINCIAL
125,4291,AVANZA PAIS - PARTIDO DE INTEGRACION SOCIAL,1,12,AMBO - HUANUCO,2173,HUANUCO,AMBO,,5,7,5,SI,2,10,MUNICIPAL PROVINCIAL
126,4200,AVANZA PAIS - PARTIDO DE INTEGRACION SOCIAL,1,8,HUACAYBAMBA - HUANUCO,2173,HUANUCO,HUACAYBAMBA,,5,5,3,SI,2,6,MUNICIPAL PROVINCIAL
127,4302,PARTIDO DEMOCRATICO SOMOS PERU,1,9,CARAVELI - AREQUIPA,14,AREQUIPA,CARAVELI,,5,5,4,SI,1,8,MUNICIPAL PROVINCIAL
128,4347,MOVIMIENTO DE INCLUSION REGIONAL,1,10,CONTRALMIRANTE VILLAR - TUMBES,2647,TUMBES,CONTRALMIRANTE VILLAR,,5,5,5,SI,4,6,MUNICIPAL PROVINCIAL
129,3354,FUERZA AREQUIPEÑA,1,12,CAMANA - AREQUIPA,1393,AREQUIPA,CAMANA,,5,7,5,SI,2,10,MUNICIPAL PROVINCIAL
130,4377,MOVIMIENTO REGIONAL AYNI,1,12,HUAYTARA - HUANCAVELICA,136,HUANCAVELICA,HUAYTARA,,5,6,6,SI,6,6,MUNICIPAL PROVINCIAL
131,4407,ALIANZA GOBIERNO UNIDAD Y ACCION,1,12,CARHUAZ - ANCASH,2856,ANCASH,CARHUAZ,,5,6,6,SI,4,8,MUNICIPAL PROVINCIAL
132,4464,RENOVACION POPULAR,1,19,ICA - ICA,22,ICA,ICA,,5,10,9,SI,5,14,MUNICIPAL PROVINCIAL
133,4476,PARTIDO DEMOCRATICO SOMOS PERU,1,10,CAMANA - AREQUIPA,14,AREQUIPA,CAMANA,,5,6,4,NO,0,10,MUNICIPAL PROVINCIAL
134,4486,NUEVA LIBERTAD,1,8,GRAN CHIMU - LA LIBERTAD,2232,LA LIBERTAD,GRAN CHIMU,,5,4,4,NO,0,8,MUNICIPAL PROVINCIAL
135,1677,ACCION POPULAR,1,14,TALARA - PIURA,4,PIURA,TALARA,,5,8,6,SI,2,12,MUNICIPAL PROVINCIAL
136,4595,UNO POR ICA,1,14,ICA - ICA,2701,ICA,ICA,,5,8,6,NO,0,14,MUNICIPAL PROVINCIAL
137,4627,PARTIDO POLITICO NACIONAL PERU LIBRE,1,17,SULLANA - PIURA,2218,PIURA,SULLANA,,5,9,8,SI,3,14,MUNICIPAL PROVINCIAL
138,4550,ORGANIZACION POLITICA UNIDAD REGIONAL,1,16,TALARA - PIURA,2711,PIURA,TALARA,,5,9,7,SI,4,12,MUNICIPAL PROVINCIAL
139,4645,MOVIMIENTO REGIONAL REVALORA,1,10,CAMANA - AREQUIPA,2719,AREQUIPA,CAMANA,,5,6,4,NO,0,10,MUNICIPAL PROVINCIAL
140,3055,VIVA EL CALLAO,1,18,CALLAO - CALLAO,2880,CALLAO,CALLAO,,5,10,8,SI,2,16,MUNICIPAL PROVINCIAL
141,4813,PARTIDO DEMOCRATICO SOMOS PERU,1,20,MARISCAL CACERES - SAN MARTIN,14,SAN MARTIN,MARISCAL CACERES,,5,11,9,SI,10,10,MUNICIPAL PROVINCIAL
142,4884,PARTIDO DEMOCRATICO SOMOS PERU,1,13,BELLAVISTA - SAN MARTIN,14,SAN MARTIN,BELLAVISTA,,5,7,6,SI,3,10,MUNICIPAL PROVINCIAL
143,4901,JUNTOS POR LORETO,1,12,REQUENA - LORETO,2871,LORETO,REQUENA,,5,7,5,SI,2,10,MUNICIPAL PROVINCIAL
144,4862,VICTORIA AMAZONENSE,1,14,CONDORCANQUI - AMAZONAS,2878,AMAZONAS,CONDORCANQUI,,5,8,6,SI,6,8,MUNICIPAL PROVINCIAL
145,4961,MOVIMIENTO INDEPENDIENTE REGIONAL HUANUCO PRIMERO,1,16,PACHITEA - HUANUCO,2162,HUANUCO,PACHITEA,,5,8,8,SI,6,10,MUNICIPAL PROVINCIAL
146,4979,PARTIDO DEMOCRATICO SOMOS PERU,1,11,PAUCARTAMBO - CUSCO,14,CUSCO,PAUCARTAMBO,,5,6,5,SI,3,8,MUNICIPAL PROVINCIAL
147,5012,MOVIMIENTO REGIONAL WARI LLAQTA,1,21,HUAMANGA - AYACUCHO,2706,AYACUCHO,HUAMANGA,,5,11,10,SI,9,12,MUNICIPAL PROVINCIAL
148,5008,MOVIMIENTO ESPERANZA REGION AMAZONICA,1,16,MAYNAS - LORETO,150,LORETO,MAYNAS,,5,8,8,NO,0,16,MUNICIPAL PROVINCIAL
149,5014,PARTIDO DEMOCRATICO SOMOS PERU,1,18,CHICLAYO - LAMBAYEQUE,14,LAMBAYEQUE,CHICLAYO,,5,10,8,SI,2,16,MUNICIPAL PROVINCIAL
150,5119,"UNIDAD, EXPERIENCIA Y TRABAJO CON ETICA",1,8,CONTRALMIRANTE VILLAR - TUMBES,2759,TUMBES,CONTRALMIRANTE VILLAR,,5,4,4,SI,2,6,MUNICIPAL PROVINCIAL
151,5132,PARTIDO DEMOCRATICO SOMOS PERU,1,16,FERREÑAFE - LAMBAYEQUE,14,LAMBAYEQUE,FERREÑAFE,,5,8,8,SI,4,12,MUNICIPAL PROVINCIAL
152,4028,PARTIDO DEMOCRATICO SOMOS PERU,1,12,HUALLAGA - SAN MARTIN,14,SAN MARTIN,HUALLAGA,,5,7,5,SI,4,8,MUNICIPAL PROVINCIAL
153,1688,MOVIMIENTO INDEPENDIENTE REGIONAL HUANUCO PRIMERO,1,12,HUAMALIES - HUANUCO,2162,HUANUCO,HUAMALIES,,5,7,5,SI,2,10,MUNICIPAL PROVINCIAL
154,5315,FRENTE POPULAR AGRICOLA FIA DEL PERU,1,14,COTABAMBAS - APURIMAC,2901,APURIMAC,COTABAMBAS,,5,7,7,SI,4,10,MUNICIPAL PROVINCIAL
155,5321,FRENTE POPULAR AGRICOLA FIA DEL PERU,1,10,CAMANA - AREQUIPA,2901,AREQUIPA,CAMANA,,5,4,6,NO,0,10,MUNICIPAL PROVINCIAL
156,5325,FRENTE POPULAR AGRICOLA FIA DEL PERU,1,14,HUAMANGA - AYACUCHO,2901,AYACUCHO,HUAMANGA,,5,8,6,SI,2,12,MUNICIPAL PROVINCIAL
157,5328,FRENTE POPULAR AGRICOLA FIA DEL PERU,1,18,MAYNAS - LORETO,2901,LORETO,MAYNAS,,5,9,9,SI,2,16,MUNICIPAL PROVINCIAL
158,3801,AVANZA PAIS - PARTIDO DE INTEGRACION SOCIAL,1,10,TARATA - TACNA,2173,TACNA,TARATA,,5,6,4,SI,4,6,MUNICIPAL PROVINCIAL
159,5291,MOVIMIENTO REGIONAL AGUA,1,18,HUAMANGA - AYACUCHO,2861,AYACUCHO,HUAMANGA,,5,10,8,SI,6,12,MUNICIPAL PROVINCIAL
160,5404,MOVIMIENTO REGIONAL UNIDAD CIVICA LIMA,1,6,OYON - LIMA,2306,LIMA,OYON,,5,4,2,NO,0,6,MUNICIPAL PROVINCIAL
161,5449,MOVIMIENTO REGIONAL UNIDAD CIVICA LIMA,1,18,HUARAL - LIMA,2306,LIMA,HUARAL,,5,9,9,SI,6,12,MUNICIPAL PROVINCIAL
162,3947,PARTIDO POLITICO NACIONAL PERU LIBRE,1,14,OXAPAMPA - PASCO,2218,PASCO,OXAPAMPA,,5,7,7,SI,4,10,MUNICIPAL PROVINCIAL
163,5498,MOVIMIENTO REGIONAL UNIDAD CIVICA LIMA,1,12,HUAURA - LIMA,2306,LIMA,HUAURA,,5,7,5,NO,0,12,MUNICIPAL PROVINCIAL
164,5517,VICTORIA AMAZONENSE,1,18,BAGUA - AMAZONAS,2878,AMAZONAS,BAGUA,,5,10,8,SI,8,10,MUNICIPAL PROVINCIAL
165,5526,UNO POR ICA,1,12,CHINCHA - ICA,2701,ICA,CHINCHA,,5,6,6,NO,0,12,MUNICIPAL PROVINCIAL
166,5514,MOVIMIENTO REGIONAL WARI LLAQTA,1,11,LUCANAS - AYACUCHO,2706,AYACUCHO,LUCANAS,,5,6,5,SI,1,10,MUNICIPAL PROVINCIAL
167,5545,FE EN EL PERU,1,14,HUARAL - LIMA,2898,LIMA,HUARAL,,5,6,8,SI,2,12,MUNICIPAL PROVINCIAL
168,5489,UNO POR ICA,1,10,NASCA - ICA,2701,ICA,NASCA,,5,6,4,NO,0,10,MUNICIPAL PROVINCIAL
169,5534,TRABAJO MAS TRABAJO,1,16,PACASMAYO - LA LIBERTAD,2884,LA LIBERTAD,PACASMAYO,,5,8,8,SI,4,12,MUNICIPAL PROVINCIAL
170,2009,REFORMA Y HONRADEZ POR MAS OBRAS,1,17,EL COLLAO - PUNO,2912,PUNO,EL COLLAO,,5,9,8,SI,7,10,MUNICIPAL PROVINCIAL
171,2854,MOVIMIENTO REGIONAL GANA AYACUCHO,1,8,HUANCA SANCOS - AYACUCHO,2694,AYACUCHO,HUANCA SANCOS,,5,5,3,SI,2,6,MUNICIPAL PROVINCIAL
172,5613,VICTORIA AMAZONENSE,1,21,UTCUBAMBA - AMAZONAS,2878,AMAZONAS,UTCUBAMBA,,5,11,10,SI,9,12,MUNICIPAL PROVINCIAL
173,5704,AVANZA PAIS - PARTIDO DE INTEGRACION SOCIAL,1,12,ZARUMILLA - TUMBES,2173,TUMBES,ZARUMILLA,,5,6,6,SI,2,10,MUNICIPAL PROVINCIAL
174,5759,RENOVACION POPULAR,1,15,CHINCHA - ICA,22,ICA,CHINCHA,,5,8,7,SI,3,12,MUNICIPAL PROVINCIAL
175,5703,FE EN EL PERU,1,19,TRUJILLO - LA LIBERTAD,2898,LA LIBERTAD,TRUJILLO,,5,10,9,SI,3,16,MUNICIPAL PROVINCIAL
176,5824,FRENTE POPULAR AGRICOLA FIA DEL PERU,1,10,JORGE BASADRE - TACNA,2901,TACNA,JORGE BASADRE,,5,5,5,SI,4,6,MUNICIPAL PROVINCIAL
177,5871,VICTORIA AMAZONENSE,1,16,BONGARA - AMAZONAS,2878,AMAZONAS,BONGARA,,5,8,8,SI,8,8,MUNICIPAL PROVINCIAL
178,5879,NUEVA LIBERTAD,1,8,JULCAN - LA LIBERTAD,2232,LA LIBERTAD,JULCAN,,5,4,4,NO,0,8,MUNICIPAL PROVINCIAL
179,5882,MOVIMIENTO REGIONAL FUERZA POR MADRE DE DIOS - MR FMDD,1,12,TAHUAMANU - MADRE DE DIOS,2300,MADRE DE DIOS,TAHUAMANU,,5,6,6,SI,6,6,MUNICIPAL PROVINCIAL
180,5939,FRENTE POPULAR AGRICOLA FIA DEL PERU,1,16,RIOJA - SAN MARTIN,2901,SAN MARTIN,RIOJA,,5,8,8,SI,4,12,MUNICIPAL PROVINCIAL
181,5951,FRENTE POPULAR AGRICOLA FIA DEL PERU,1,17,SULLANA - PIURA,2901,PIURA,SULLANA,,5,9,8,SI,3,14,MUNICIPAL PROVINCIAL
182,5949,PARTIDO DEMOCRATICO SOMOS PERU,1,11,ACOMAYO - CUSCO,14,CUSCO,ACOMAYO,,5,6,5,SI,5,6,MUNICIPAL PROVINCIAL
183,5911,TRABAJO MAS TRABAJO,1,17,VIRU - LA LIBERTAD,2884,LA LIBERTAD,VIRU,,5,9,8,SI,7,10,MUNICIPAL PROVINCIAL
184,5966,FRENTE POPULAR AGRICOLA FIA DEL PERU,1,12,PAITA - PIURA,2901,PIURA,PAITA,,5,5,7,NO,0,12,MUNICIPAL PROVINCIAL
185,5993,VICTORIA AMAZONENSE,1,12,RODRIGUEZ DE MENDOZA - AMAZONAS,2878,AMAZONAS,RODRIGUEZ DE MENDOZA,,5,7,5,SI,4,8,MUNICIPAL PROVINCIAL
186,6078,UNO POR ICA,1,12,PISCO - ICA,2701,ICA,PISCO,,5,6,6,NO,0,12,MUNICIPAL PROVINCIAL
187,3327,FUERZA INKA AMAZONICA,1,22,CANCHIS - CUSCO,2164,CUSCO,CANCHIS,,5,12,10,SI,10,12,MUNICIPAL PROVINCIAL
188,6127,FRENTE REGIONAL DE CAJAMARCA,1,11,CONTUMAZA - CAJAMARCA,160,CAJAMARCA,CONTUMAZA,,5,6,5,SI,3,8,MUNICIPAL PROVINCIAL
189,6176,SOCIOS POR ANCASH,1,8,OCROS - ANCASH,2881,ANCASH,OCROS,,5,4,4,SI,2,6,MUNICIPAL PROVINCIAL
190,6265,FRENTE POPULAR AGRICOLA FIA DEL PERU,1,13,UCAYALI - LORETO,2901,LORETO,UCAYALI,,5,7,6,SI,3,10,MUNICIPAL PROVINCIAL
191,6310,FRENTE POPULAR AGRICOLA FIA DEL PERU,1,12,ALTO AMAZONAS - LORETO,2901,LORETO,ALTO AMAZONAS,,5,7,5,NO,0,12,MUNICIPAL PROVINCIAL
192,6331,FRENTE POPULAR AGRICOLA FIA DEL PERU,1,10,ILO - MOQUEGUA,2901,MOQUEGUA,ILO,,5,4,6,NO,0,10,MUNICIPAL PROVINCIAL
193,6363,FRENTE POPULAR AGRICOLA FIA DEL PERU,1,17,CAÑETE - LIMA,2901,LIMA,CAÑETE,,5,9,8,SI,5,12,MUNICIPAL PROVINCIAL
194,6364,FRENTE POPULAR AGRICOLA FIA DEL PERU,1,19,CHICLAYO - LAMBAYEQUE,2901,LAMBAYEQUE,CHICLAYO,,5,10,9,SI,3,16,MUNICIPAL PROVINCIAL
195,6365,FRENTE POPULAR AGRICOLA FIA DEL PERU,1,15,VIRU - LA LIBERTAD,2901,LA LIBERTAD,VIRU,,5,8,7,SI,5,10,MUNICIPAL PROVINCIAL
196,6368,FRENTE POPULAR AGRICOLA FIA DEL PERU,1,12,HUARI - ANCASH,2901,ANCASH,HUARI,,5,6,6,SI,2,10,MUNICIPAL PROVINCIAL
197,6373,FRENTE POPULAR AGRICOLA FIA DEL PERU,1,10,ANTABAMBA - APURIMAC,2901,APURIMAC,ANTABAMBA,,5,5,5,SI,4,6,MUNICIPAL PROVINCIAL
198,6384,FRENTE POPULAR AGRICOLA FIA DEL PERU,1,13,MARISCAL RAMON CASTILLA - LORETO,2901,LORETO,MARISCAL RAMON CASTILLA,,5,7,6,SI,3,10,MUNICIPAL PROVINCIAL
199,6387,FRENTE POPULAR AGRICOLA FIA DEL PERU,2,12,MARISCAL RAMON CASTILLA - LORETO,2901,LORETO,MARISCAL RAMON CASTILLA,,5,7,5,SI,2,10,MUNICIPAL PROVINCIAL
200,6394,FRENTE POPULAR AGRICOLA FIA DEL PERU,1,12,PACHITEA - HUANUCO,2901,HUANUCO,PACHITEA,,5,6,6,SI,2,10,MUNICIPAL PROVINCIAL
201,6399,FRENTE POPULAR AGRICOLA FIA DEL PERU,1,10,LA MAR - AYACUCHO,2901,AYACUCHO,LA MAR,,5,5,5,NO,0,10,MUNICIPAL PROVINCIAL
202,6400,FRENTE POPULAR AGRICOLA FIA DEL PERU,1,8,CANGALLO - AYACUCHO,2901,AYACUCHO,CANGALLO,,5,4,4,NO,0,8,MUNICIPAL PROVINCIAL
203,6402,FRENTE POPULAR AGRICOLA FIA DEL PERU,1,8,PALPA - ICA,2901,ICA,PALPA,,5,4,4,SI,2,6,MUNICIPAL PROVINCIAL
204,6457,FUERZA AREQUIPEÑA,1,10,ISLAY - AREQUIPA,1393,AREQUIPA,ISLAY,,5,6,4,NO,0,10,MUNICIPAL PROVINCIAL
205,6448,SOMOS PUEBLO,1,12,CARABAYA - PUNO,2657,PUNO,CARABAYA,,5,7,5,SI,2,10,MUNICIPAL PROVINCIAL
206,6228,VICTORIA AMAZONENSE,1,14,CHACHAPOYAS - AMAZONAS,2878,AMAZONAS,CHACHAPOYAS,,5,8,6,SI,4,10,MUNICIPAL PROVINCIAL
207,6523,TODOS SOMOS UCAYALI,1,16,CORONEL PORTILLO - UCAYALI,1396,UCAYALI,CORONEL PORTILLO,,5,8,8,SI,2,14,MUNICIPAL PROVINCIAL
208,6533,PARTIDO DEMOCRATICO SOMOS PERU,1,16,CUSCO - CUSCO,14,CUSCO,CUSCO,,5,9,7,SI,2,14,MUNICIPAL PROVINCIAL
209,6243,MOVIMIENTO REGIONAL AGUA,1,10,PAUCAR DEL SARA SARA - AYACUCHO,2861,AYACUCHO,PAUCAR DEL SARA SARA,,5,5,5,SI,4,6,MUNICIPAL PROVINCIAL
210,6647,"AREQUIPA, TRADICION Y FUTURO",1,9,LA UNION - AREQUIPA,142,AREQUIPA,LA UNION,,5,5,4,SI,3,6,MUNICIPAL PROVINCIAL
211,6650,MOVIMIENTO REGIONAL AGUA,1,10,CASTROVIRREYNA - HUANCAVELICA,2681,HUANCAVELICA,CASTROVIRREYNA,,5,6,4,SI,4,6,MUNICIPAL PROVINCIAL
212,4994,MOVIMIENTO INDEPENDIENTE REGIONAL HUANUCO PRIMERO,1,18,HUANUCO - HUANUCO,2162,HUANUCO,HUANUCO,,5,10,8,SI,4,14,MUNICIPAL PROVINCIAL
213,6676,MORAL Y DESARROLLO,1,27,SAN ROMAN - PUNO,292,PUNO,SAN ROMAN,,5,14,13,SI,13,14,MUNICIPAL PROVINCIAL
214,6744,MOVIMIENTO REGIONAL UNIDAD CIVICA LIMA,1,15,CAÑETE - LIMA,2306,LIMA,CAÑETE,,5,8,7,SI,3,12,MUNICIPAL PROVINCIAL
215,6747,ALIANZA GOBIERNO UNIDAD Y ACCION,1,14,HUAYLAS - ANCASH,2856,ANCASH,HUAYLAS,,5,7,7,SI,4,10,MUNICIPAL PROVINCIAL
216,6255,PARTIDO POLITICO NACIONAL PERU LIBRE,1,20,MARISCAL NIETO - MOQUEGUA,2218,MOQUEGUA,MARISCAL NIETO,,5,10,10,SI,10,10,MUNICIPAL PROVINCIAL
217,1572,MOVIMIENTO CIVICO PERUANO,1,16,TACNA - TACNA,2351,TACNA,TACNA,,5,8,8,SI,2,14,MUNICIPAL PROVINCIAL
218,6804,MOVIMIENTO POLITICO CAMBIEMOS X HCO,1,14,LEONCIO PRADO - HUANUCO,2733,HUANUCO,LEONCIO PRADO,,5,7,7,SI,2,12,MUNICIPAL PROVINCIAL
219,655,ORGANIZACION POLITICA UNIDAD REGIONAL,1,20,PIURA - PIURA,2711,PIURA,PIURA,,5,11,9,SI,4,16,MUNICIPAL PROVINCIAL
220,6221,MOVIMIENTO REGIONAL AGUA,1,10,VICTOR FAJARDO - AYACUCHO,2861,AYACUCHO,VICTOR FAJARDO,,5,5,5,SI,4,6,MUNICIPAL PROVINCIAL
221,5959,PARTIDO POLITICO NACIONAL PERU LIBRE,1,8,TAHUAMANU - MADRE DE DIOS,2218,MADRE DE DIOS,TAHUAMANU,,5,4,4,SI,2,6,MUNICIPAL PROVINCIAL
222,844,MOVIMIENTO INDEPENDIENTE REGIONAL HUANUCO PRIMERO,1,12,PUERTO INCA - HUANUCO,2162,HUANUCO,PUERTO INCA,,5,6,6,SI,4,8,MUNICIPAL PROVINCIAL
223,1005,MOVIMIENTO INDEPENDIENTE REGIONAL HUANUCO PRIMERO,1,10,MARAÑON - HUANUCO,2162,HUANUCO,MARAÑON,,5,6,4,SI,2,8,MUNICIPAL PROVINCIAL
224,6917,ALIANZA GOBIERNO UNIDAD Y ACCION,1,8,MARISCAL LUZURIAGA - ANCASH,2856,ANCASH,MARISCAL LUZURIAGA,,5,5,3,SI,2,6,MUNICIPAL PROVINCIAL
225,6968,"MOVIMIENTO POLITICO ""COMPROMISO Y DESARROLLO""",2,10,ILO - MOQUEGUA,2915,MOQUEGUA,ILO,,5,5,5,NO,0,10,MUNICIPAL PROVINCIAL
226,6986,JUNIN RENACE,1,12,JAUJA - JUNIN,2716,JUNIN,JAUJA,,5,7,5,SI,2,10,MUNICIPAL PROVINCIAL
227,6997,"UNIDAD, EXPERIENCIA Y TRABAJO CON ETICA",1,14,TUMBES - TUMBES,2759,TUMBES,TUMBES,,5,7,7,SI,2,12,MUNICIPAL PROVINCIAL
228,6960,GESTIONANDO OBRAS Y OPORTUNIDADES CON LIDERAZGO,2,12,LAMPA - PUNO,2667,PUNO,LAMPA,,5,7,5,SI,4,8,MUNICIPAL PROVINCIAL
229,6833,FE EN EL PERU,1,58,LIMA - LIMA,2898,LIMA,LIMA,,5,30,28,SI,18,40,MUNICIPAL PROVINCIAL
230,7023,ALIANZA GOBIERNO UNIDAD Y ACCION,1,15,PALLASCA - ANCASH,2856,ANCASH,PALLASCA,,5,8,7,SI,7,8,MUNICIPAL PROVINCIAL
231,5725,MOVIMIENTO REGIONAL GANA AYACUCHO,1,17,HUANTA - AYACUCHO,2694,AYACUCHO,HUANTA,,5,9,8,SI,7,10,MUNICIPAL PROVINCIAL
232,7144,FE EN EL PERU,1,14,ASCOPE - LA LIBERTAD,2898,LA LIBERTAD,ASCOPE,,5,8,6,SI,2,12,MUNICIPAL PROVINCIAL
233,7174,FE EN EL PERU,1,16,SANTA - ANCASH,2898,ANCASH,SANTA,,5,8,8,SI,2,14,MUNICIPAL PROVINCIAL
234,132,FRENTE REGIONAL DE CAJAMARCA,1,14,SAN IGNACIO - CAJAMARCA,160,CAJAMARCA,SAN IGNACIO,,5,8,6,SI,2,12,MUNICIPAL PROVINCIAL
235,7182,PARTIDO POLITICO NACIONAL PERU LIBRE,1,22,PASCO - PASCO,2218,PASCO,PASCO,,5,11,11,SI,10,12,MUNICIPAL PROVINCIAL
236,7239,PARTIDO DEMOCRATICO SOMOS PERU,1,8,JORGE BASADRE - TACNA,14,TACNA,JORGE BASADRE,,5,4,4,SI,2,6,MUNICIPAL PROVINCIAL
237,7247,FE EN EL PERU,1,10,LUCANAS - AYACUCHO,2898,AYACUCHO,LUCANAS,,5,5,5,NO,0,10,MUNICIPAL PROVINCIAL
238,6272,RENOVACION POPULAR,1,8,GRAN CHIMU - LA LIBERTAD,22,LA LIBERTAD,GRAN CHIMU,,5,4,4,NO,0,8,MUNICIPAL PROVINCIAL
239,7301,FRENTE REGIONAL DE CAJAMARCA,1,20,CAJABAMBA - CAJAMARCA,160,CAJAMARCA,CAJABAMBA,,5,11,9,SI,10,10,MUNICIPAL PROVINCIAL
240,7317,PATRIA JOVEN,1,7,OYON - LIMA,553,LIMA,OYON,,5,4,3,SI,1,6,MUNICIPAL PROVINCIAL
241,3140,RENOVACION POPULAR,1,13,VIRU - LA LIBERTAD,22,LA LIBERTAD,VIRU,,5,7,6,SI,3,10,MUNICIPAL PROVINCIAL
242,7346,ACCION POPULAR,1,12,HUALLAGA - SAN MARTIN,4,SAN MARTIN,HUALLAGA,,5,7,5,SI,4,8,MUNICIPAL PROVINCIAL
243,7327,FE EN EL PERU,1,15,CORONEL PORTILLO - UCAYALI,2898,UCAYALI,CORONEL PORTILLO,,5,8,7,SI,1,14,MUNICIPAL PROVINCIAL
244,5171,RENOVACION POPULAR,1,14,CELENDIN - CAJAMARCA,22,CAJAMARCA,CELENDIN,,5,8,6,SI,4,10,MUNICIPAL PROVINCIAL
245,7365,ACCION POPULAR,1,10,MARISCAL CACERES - SAN MARTIN,4,SAN MARTIN,MARISCAL CACERES,,5,5,5,NO,0,10,MUNICIPAL PROVINCIAL
246,5447,RENOVACION POPULAR,1,15,SAN IGNACIO - CAJAMARCA,22,CAJAMARCA,SAN IGNACIO,,5,8,7,SI,3,12,MUNICIPAL PROVINCIAL
247,5482,RENOVACION POPULAR,1,14,JAEN - CAJAMARCA,22,CAJAMARCA,JAEN,,5,8,6,SI,2,12,MUNICIPAL PROVINCIAL
248,7392,PATRIA JOVEN,1,8,CANTA - LIMA,553,LIMA,CANTA,,5,4,4,SI,2,6,MUNICIPAL PROVINCIAL
249,1130,MOVIMENTO INDEPENDIENTE REGIONAL FUERZA TACNA,1,8,CANDARAVE - TACNA,2432,TACNA,CANDARAVE,,5,5,3,SI,2,6,MUNICIPAL PROVINCIAL
250,7426,PARTIDO DEMOCRATICO SOMOS PERU,1,14,NASCA - ICA,14,ICA,NASCA,,5,8,6,SI,4,10,MUNICIPAL PROVINCIAL
251,4331,PARTIDO DEMOCRATICO SOMOS PERU,1,15,PISCO - ICA,14,ICA,PISCO,,5,8,7,SI,3,12,MUNICIPAL PROVINCIAL
252,7441,ACCION POPULAR,2,15,SAN MARTIN - SAN MARTIN,4,SAN MARTIN,SAN MARTIN,,5,8,7,SI,3,12,MUNICIPAL PROVINCIAL
253,7451,FE EN EL PERU,1,16,PIURA - PIURA,2898,PIURA,PIURA,,5,9,7,NO,0,16,MUNICIPAL PROVINCIAL
254,7469,FE EN EL PERU,1,12,TUMBES - TUMBES,2898,TUMBES,TUMBES,,5,6,6,NO,0,12,MUNICIPAL PROVINCIAL
255,7465,ACCION POPULAR,1,15,SAN MARTIN - SAN MARTIN,4,SAN MARTIN,SAN MARTIN,,5,8,7,SI,3,12,MUNICIPAL PROVINCIAL
256,7483,PARTIDO PATRIOTICO DEL PERU,1,20,CALLAO - CALLAO,2869,CALLAO,CALLAO,,5,10,10,SI,4,16,MUNICIPAL PROVINCIAL
257,7492,MOVIMIENTO INDEPENDIENTE TRABAJANDO PARA TODOS,1,11,CHURCAMPA - HUANCAVELICA,226,HUANCAVELICA,CHURCAMPA,,5,6,5,SI,3,8,MUNICIPAL PROVINCIAL
258,787,MOVIMIENTO REGIONAL JUVENTUD PASQUEÑA,1,8,DANIEL ALCIDES CARRION - PASCO,2753,PASCO,DANIEL ALCIDES CARRION,,5,4,4,NO,0,8,MUNICIPAL PROVINCIAL
259,7516,FE EN EL PERU,1,14,MOYOBAMBA - SAN MARTIN,2898,SAN MARTIN,MOYOBAMBA,,5,8,6,SI,2,12,MUNICIPAL PROVINCIAL
260,786,MOVIMIENTO REGIONAL JUVENTUD PASQUEÑA,1,12,PASCO - PASCO,2753,PASCO,PASCO,,5,7,5,NO,0,12,MUNICIPAL PROVINCIAL
261,780,MOVIMIENTO REGIONAL JUVENTUD PASQUEÑA,1,10,OXAPAMPA - PASCO,2753,PASCO,OXAPAMPA,,5,6,4,NO,0,10,MUNICIPAL PROVINCIAL
262,7531,PARTIDO DEMOCRATICO SOMOS PERU,1,16,CHINCHA - ICA,14,ICA,CHINCHA,,5,8,8,SI,4,12,MUNICIPAL PROVINCIAL
263,5484,"PARA LA TRANSFORMACION, INTEGRACION Y ALIANZA-PATRIA",1,16,TACNA - TACNA,2904,TACNA,TACNA,,5,9,7,SI,2,14,MUNICIPAL PROVINCIAL
264,5587,NUEVA LIBERTAD,1,13,ASCOPE - LA LIBERTAD,2232,LA LIBERTAD,ASCOPE,,5,7,6,SI,1,12,MUNICIPAL PROVINCIAL
265,7524,PATRIA JOVEN,1,17,HUAURA - LIMA,553,LIMA,HUAURA,,5,8,9,SI,5,12,MUNICIPAL PROVINCIAL
266,7575,ACCION POPULAR,1,10,TOCACHE - SAN MARTIN,4,SAN MARTIN,TOCACHE,,5,5,5,NO,0,10,MUNICIPAL PROVINCIAL
267,7561,SOMOS PUEBLO,1,26,SAN ROMAN - PUNO,2657,PUNO,SAN ROMAN,,5,13,13,SI,12,14,MUNICIPAL PROVINCIAL
268,7528,FE EN EL PERU,1,18,SULLANA - PIURA,2898,PIURA,SULLANA,,5,10,8,NO,4,14,MUNICIPAL PROVINCIAL
269,7597,MOVIMIENTO REGIONAL GANA AYACUCHO,1,9,PAUCAR DEL SARA SARA - AYACUCHO,2694,AYACUCHO,PAUCAR DEL SARA SARA,,5,5,4,SI,3,6,MUNICIPAL PROVINCIAL
270,7678,MOVIMIENTO ESPERANZA REGION AMAZONICA,1,12,ALTO AMAZONAS - LORETO,150,LORETO,ALTO AMAZONAS,,5,6,6,NO,0,12,MUNICIPAL PROVINCIAL
271,7685,ACCION POPULAR,1,13,MOYOBAMBA - SAN MARTIN,4,SAN MARTIN,MOYOBAMBA,,5,7,6,SI,1,12,MUNICIPAL PROVINCIAL
272,7700,YO AREQUIPA,1,8,CONDESUYOS - AREQUIPA,2744,AREQUIPA,CONDESUYOS,,5,5,3,SI,2,6,MUNICIPAL PROVINCIAL
273,3031,IGUALDAD NACIONAL CRISTIANA AUTONOMA - INCA,1,16,TACNA - TACNA,1403,TACNA,TACNA,,5,9,7,SI,2,14,MUNICIPAL PROVINCIAL
274,3771,AVANZA PAIS - PARTIDO DE INTEGRACION SOCIAL,1,8,TAHUAMANU - MADRE DE DIOS,2173,MADRE DE DIOS,TAHUAMANU,,5,4,4,SI,2,6,MUNICIPAL PROVINCIAL
275,7793,RENOVACION POPULAR,1,14,PISCO - ICA,22,ICA,PISCO,,5,7,7,SI,2,12,MUNICIPAL PROVINCIAL
276,7781,CAMINEMOS JUNTOS POR JUNIN,1,15,SATIPO - JUNIN,122,JUNIN,SATIPO,,5,8,7,SI,3,12,MUNICIPAL PROVINCIAL
277,4572,IGUALDAD NACIONAL CRISTIANA AUTONOMA - INCA,2,16,TACNA - TACNA,1403,TACNA,TACNA,,5,9,7,SI,2,14,MUNICIPAL PROVINCIAL
278,4545,IGUALDAD NACIONAL CRISTIANA AUTONOMA - INCA,1,8,JORGE BASADRE - TACNA,1403,TACNA,JORGE BASADRE,,5,5,3,SI,2,6,MUNICIPAL PROVINCIAL
279,5494,ALIANZA GOBIERNO UNIDAD Y ACCION,1,12,HUARMEY - ANCASH,2856,ANCASH,HUARMEY,,5,7,5,SI,4,8,MUNICIPAL PROVINCIAL
280,6813,PARTIDO POLITICO NACIONAL PERU LIBRE,1,12,TAMBOPATA - MADRE DE DIOS,2218,MADRE DE DIOS,TAMBOPATA,,5,6,6,NO,0,12,MUNICIPAL PROVINCIAL
281,7880,PARTIDO POLITICO NACIONAL PERU LIBRE,1,6,MANU - MADRE DE DIOS,2218,MADRE DE DIOS,MANU,,5,3,3,NO,0,6,MUNICIPAL PROVINCIAL
282,7689,PATRIA JOVEN,1,14,CAÑETE - LIMA,553,LIMA,CAÑETE,,5,7,7,SI,2,12,MUNICIPAL PROVINCIAL
283,6235,RENOVACION POPULAR,1,16,HUANUCO - HUANUCO,22,HUANUCO,HUANUCO,,5,8,8,SI,2,14,MUNICIPAL PROVINCIAL
284,8020,PATRIA JOVEN,1,14,HUARAL - LIMA,553,LIMA,HUARAL,,5,8,6,SI,2,12,MUNICIPAL PROVINCIAL
285,4559,RENOVACION POPULAR,1,14,HUARAZ - ANCASH,22,ANCASH,HUARAZ,,5,7,7,SI,2,12,MUNICIPAL PROVINCIAL
286,8145,REFORMA Y HONRADEZ POR MAS OBRAS,1,13,MELGAR - PUNO,2912,PUNO,MELGAR,,5,7,6,SI,3,10,MUNICIPAL PROVINCIAL
287,8205,ACCION POPULAR,1,12,MORROPON - PIURA,4,PIURA,MORROPON,,5,6,6,NO,0,12,MUNICIPAL PROVINCIAL
288,8271,MOVIMIENTO INDEPENDIENTE TRABAJANDO PARA TODOS,1,14,TAYACAJA - HUANCAVELICA,226,HUANCAVELICA,TAYACAJA,,5,8,6,SI,4,10,MUNICIPAL PROVINCIAL
289,767,NUESTRO ILO - MOQUEGUA - SANCHEZ CERRO,1,10,MARISCAL NIETO - MOQUEGUA,2497,MOQUEGUA,MARISCAL NIETO,,5,6,4,NO,0,10,MUNICIPAL PROVINCIAL
290,8262,ORGANIZACION POLITICA UNIDAD REGIONAL,1,14,SECHURA - PIURA,2711,PIURA,SECHURA,,5,8,6,SI,4,10,MUNICIPAL PROVINCIAL
291,5877,MOVIMIENTO CIVICO PERUANO,1,10,TARATA - TACNA,2351,TACNA,TARATA,,5,6,4,SI,4,6,MUNICIPAL PROVINCIAL
292,8369,RENOVACION POPULAR,1,14,NASCA - ICA,22,ICA,NASCA,,5,7,7,SI,4,10,MUNICIPAL PROVINCIAL
293,2011,MOVIMIENTO INDEPENDIENTE REGIONAL HUANUCO PRIMERO,1,8,HUACAYBAMBA - HUANUCO,2162,HUANUCO,HUACAYBAMBA,,5,4,4,SI,2,6,MUNICIPAL PROVINCIAL
294,8333,PARTIDO DEMOCRATICO SOMOS PERU,1,14,CUTERVO - CAJAMARCA,14,CAJAMARCA,CUTERVO,,5,8,6,SI,2,12,MUNICIPAL PROVINCIAL
295,8380,SOCIOS POR ANCASH,1,12,HUARMEY - ANCASH,2881,ANCASH,HUARMEY,,5,6,6,SI,4,8,MUNICIPAL PROVINCIAL
296,8379,SENTIMIENTO AMAZONENSE REGIONAL,1,12,CHACHAPOYAS - AMAZONAS,2277,AMAZONAS,CHACHAPOYAS,,5,6,6,SI,2,10,MUNICIPAL PROVINCIAL
297,5866,TRABAJO MAS TRABAJO,1,12,SANTIAGO DE CHUCO - LA LIBERTAD,2884,LA LIBERTAD,SANTIAGO DE CHUCO,,5,7,5,SI,2,10,MUNICIPAL PROVINCIAL
298,8063,FUERZA AREQUIPEÑA,1,12,CAYLLOMA - AREQUIPA,1393,AREQUIPA,CAYLLOMA,,5,7,5,SI,2,10,MUNICIPAL PROVINCIAL
299,8407,MOVIMIENTO INDEPENDIENTE AMOR POR MADRE DE DIOS,1,12,MANU - MADRE DE DIOS,1441,MADRE DE DIOS,MANU,,5,7,5,SI,6,6,MUNICIPAL PROVINCIAL
300,8351,MOVIMIENTO INDEPENDIENTE REGIONAL CAMBIO UCAYALINO,1,12,ATALAYA - UCAYALI,2278,UCAYALI,ATALAYA,,5,6,6,SI,2,10,MUNICIPAL PROVINCIAL
301,8321,AVANZA PAIS - PARTIDO DE INTEGRACION SOCIAL,1,9,LAURICOCHA - HUANUCO,2173,HUANUCO,LAURICOCHA,,5,5,4,SI,3,6,MUNICIPAL PROVINCIAL
302,8452,JUNIN RENACE,1,9,YAULI - JUNIN,2716,JUNIN,YAULI,,5,5,4,SI,1,8,MUNICIPAL PROVINCIAL
303,8009,YO AREQUIPA,1,18,ISLAY - AREQUIPA,2744,AREQUIPA,ISLAY,,5,9,9,SI,8,10,MUNICIPAL PROVINCIAL
304,8196,SIEMPRE TACNA,1,10,JORGE BASADRE - TACNA,2178,TACNA,JORGE BASADRE,,5,5,5,SI,4,6,MUNICIPAL PROVINCIAL
305,8526,AVANZA PAIS - PARTIDO DE INTEGRACION SOCIAL,1,7,JORGE BASADRE - TACNA,2173,TACNA,JORGE BASADRE,,5,4,3,SI,1,6,MUNICIPAL PROVINCIAL
306,2835,ALIANZA GOBIERNO UNIDAD Y ACCION,1,6,AIJA - ANCASH,2856,ANCASH,AIJA,,5,3,3,NO,0,6,MUNICIPAL PROVINCIAL
307,8531,PARTIDO DEMOCRATICO SOMOS PERU,1,12,LA CONVENCION - CUSCO,14,CUSCO,LA CONVENCION,,5,6,6,NO,0,12,MUNICIPAL PROVINCIAL
308,5789,ACCION POPULAR,1,10,CONTUMAZA - CAJAMARCA,4,CAJAMARCA,CONTUMAZA,,5,5,5,SI,2,8,MUNICIPAL PROVINCIAL
309,5762,ACCION POPULAR,1,12,JAEN - CAJAMARCA,4,CAJAMARCA,JAEN,,5,7,5,NO,0,12,MUNICIPAL PROVINCIAL
310,5754,ACCION POPULAR,1,10,CELENDIN - CAJAMARCA,4,CAJAMARCA,CELENDIN,,5,6,4,NO,0,10,MUNICIPAL PROVINCIAL
311,5741,ACCION POPULAR,1,10,CAJABAMBA - CAJAMARCA,4,CAJAMARCA,CAJABAMBA,,5,6,4,NO,0,10,MUNICIPAL PROVINCIAL
312,8626,PARTIDO DEMOCRATICO SOMOS PERU,1,16,TUMBES - TUMBES,14,TUMBES,TUMBES,,5,8,8,SI,4,12,MUNICIPAL PROVINCIAL
313,8659,PARTIDO DEMOCRATICO SOMOS PERU,1,8,CONTRALMIRANTE VILLAR - TUMBES,14,TUMBES,CONTRALMIRANTE VILLAR,,5,4,4,SI,2,6,MUNICIPAL PROVINCIAL
314,8662,PARTIDO DEMOCRATICO SOMOS PERU,1,14,CHUMBIVILCAS - CUSCO,14,CUSCO,CHUMBIVILCAS,,5,8,6,SI,4,10,MUNICIPAL PROVINCIAL
315,8638,MOVIMIENTO REGIONAL AGUA,1,10,HUANCA SANCOS - AYACUCHO,2861,AYACUCHO,HUANCA SANCOS,,5,5,5,SI,4,6,MUNICIPAL PROVINCIAL
316,8640,JUNIN RENACE,1,21,CHANCHAMAYO - JUNIN,2716,JUNIN,CHANCHAMAYO,,5,11,10,SI,9,12,MUNICIPAL PROVINCIAL
317,8676,PARTIDO DEMOCRATICO SOMOS PERU,1,13,ZARUMILLA - TUMBES,14,TUMBES,ZARUMILLA,,5,7,6,SI,3,10,MUNICIPAL PROVINCIAL
318,8752,PARTIDO DEMOCRATICO SOMOS PERU,1,14,CALCA - CUSCO,14,CUSCO,CALCA,,5,8,6,SI,4,10,MUNICIPAL PROVINCIAL
319,8801,FUERZA AREQUIPEÑA,1,6,LA UNION - AREQUIPA,1393,AREQUIPA,LA UNION,,5,4,2,NO,0,6,MUNICIPAL PROVINCIAL
320,8763,PARTIDO DEMOCRATICO SOMOS PERU,1,13,TARMA - JUNIN,14,JUNIN,TARMA,,5,7,6,SI,3,10,MUNICIPAL PROVINCIAL
321,8829,PARTIDO DEMOCRATICO SOMOS PERU,1,15,CAÑETE - LIMA,14,LIMA,CAÑETE,,5,7,8,SI,3,12,MUNICIPAL PROVINCIAL
322,8661,AVANZA PAIS - PARTIDO DE INTEGRACION SOCIAL,1,8,MANU - MADRE DE DIOS,2173,MADRE DE DIOS,MANU,,5,4,4,SI,2,6,MUNICIPAL PROVINCIAL
323,8502,PARTIDO DEMOCRATICO SOMOS PERU,1,14,SAN ROMAN - PUNO,14,PUNO,SAN ROMAN,,5,7,7,NO,0,14,MUNICIPAL PROVINCIAL
324,2507,MOVIMIENTO REGIONAL AYNI,1,16,ACOBAMBA - HUANCAVELICA,136,HUANCAVELICA,ACOBAMBA,,5,9,7,SI,8,8,MUNICIPAL PROVINCIAL
325,8878,MOVIMIENTO REGIONAL SIERRA Y SELVA CONTIGO JUNIN,1,9,YAULI - JUNIN,2680,JUNIN,YAULI,,5,5,4,SI,1,8,MUNICIPAL PROVINCIAL
326,8905,MOVIMIENTO REGIONAL WARI LLAQTA,1,14,HUANTA - AYACUCHO,2706,AYACUCHO,HUANTA,,5,7,7,SI,4,10,MUNICIPAL PROVINCIAL
327,8873,PIURA RENACE,1,15,TALARA - PIURA,2876,PIURA,TALARA,,5,8,7,SI,3,12,MUNICIPAL PROVINCIAL
328,5841,MOVIMIENTO INDEPENDIENTE LORETO - MI LORETO,1,15,ALTO AMAZONAS - LORETO,315,LORETO,ALTO AMAZONAS,,5,8,7,SI,3,12,MUNICIPAL PROVINCIAL
329,5576,AVANZA PAIS - PARTIDO DE INTEGRACION SOCIAL,1,10,BELLAVISTA - SAN MARTIN,2173,SAN MARTIN,BELLAVISTA,,5,6,4,NO,0,10,MUNICIPAL PROVINCIAL
330,1404,RENOVACION POPULAR,1,16,CHACHAPOYAS - AMAZONAS,22,AMAZONAS,CHACHAPOYAS,,5,8,8,SI,6,10,MUNICIPAL PROVINCIAL
331,5260,AVANZA PAIS - PARTIDO DE INTEGRACION SOCIAL,1,10,EL DORADO - SAN MARTIN,2173,SAN MARTIN,EL DORADO,,5,6,4,SI,2,8,MUNICIPAL PROVINCIAL
332,6168,MOVIMIENTO INDEPENDIENTE LORETO - MI LORETO,1,13,DATEM DEL MARAÑON - LORETO,315,LORETO,DATEM DEL MARAÑON,,5,7,6,SI,3,10,MUNICIPAL PROVINCIAL
333,8989,SOCIOS POR ANCASH,1,8,ASUNCION - ANCASH,2881,ANCASH,ASUNCION,,5,5,3,SI,2,6,MUNICIPAL PROVINCIAL
334,8745,PARTIDO DEMOCRATICO SOMOS PERU,1,8,GENERAL SANCHEZ CERRO - MOQUEGUA,14,MOQUEGUA,GENERAL SANCHEZ CERRO,,5,5,3,SI,2,6,MUNICIPAL PROVINCIAL
335,8710,PARTIDO DEMOCRATICO SOMOS PERU,1,16,ILO - MOQUEGUA,14,MOQUEGUA,ILO,,5,9,7,SI,6,10,MUNICIPAL PROVINCIAL
336,8421,MOVIMIENTO REGIONAL AGUA,1,13,LA MAR - AYACUCHO,2861,AYACUCHO,LA MAR,,5,7,6,SI,3,10,MUNICIPAL PROVINCIAL
337,9016,PARTIDO MORADO,1,10,BAGUA - AMAZONAS,2840,AMAZONAS,BAGUA,,5,5,5,NO,0,10,MUNICIPAL PROVINCIAL
338,6225,MOVIMIENTO INDEPENDIENTE LORETO - MI LORETO,1,14,LORETO - LORETO,315,LORETO,LORETO,,5,7,7,SI,4,10,MUNICIPAL PROVINCIAL
339,8951,MOVIMIENTO REGIONAL SIERRA Y SELVA CONTIGO JUNIN,1,22,CONCEPCION - JUNIN,2680,JUNIN,CONCEPCION,,5,12,10,SI,12,10,MUNICIPAL PROVINCIAL
340,6979,MOVIMIENTO INDEPENDIENTE LORETO - MI LORETO,1,21,MAYNAS - LORETO,315,LORETO,MAYNAS,,5,11,10,SI,5,16,MUNICIPAL PROVINCIAL
341,9047,PARTIDO MORADO,1,10,CHACHAPOYAS - AMAZONAS,2840,AMAZONAS,CHACHAPOYAS,,5,4,6,NO,0,10,MUNICIPAL PROVINCIAL
342,8986,PASCO VERDE,1,14,OXAPAMPA - PASCO,2353,PASCO,OXAPAMPA,,5,8,6,SI,4,10,MUNICIPAL PROVINCIAL
343,9116,PARTIDO DEMOCRATICO SOMOS PERU,1,6,CORONGO - ANCASH,14,ANCASH,CORONGO,,5,3,3,NO,0,6,MUNICIPAL PROVINCIAL
344,7321,AVANZA PAIS - PARTIDO DE INTEGRACION SOCIAL,1,16,HUAURA - LIMA,2173,LIMA,HUAURA,,5,9,7,SI,4,12,MUNICIPAL PROVINCIAL
345,9052,PARTIDO DEMOCRATICO SOMOS PERU,1,21,MAYNAS - LORETO,14,LORETO,MAYNAS,,5,11,10,SI,5,16,MUNICIPAL PROVINCIAL
346,7107,MOVIMIENTO INDEPENDIENTE LORETO - MI LORETO,1,7,PUTUMAYO - LORETO,315,LORETO,PUTUMAYO,,5,4,3,SI,1,6,MUNICIPAL PROVINCIAL
347,9140,ALIANZA GOBIERNO UNIDAD Y ACCION,1,9,ASUNCION - ANCASH,2856,ANCASH,ASUNCION,,5,5,4,SI,3,6,MUNICIPAL PROVINCIAL
348,6914,MOVIMIENTO REGIONAL AGUA,1,20,HUANTA - AYACUCHO,2861,AYACUCHO,HUANTA,,5,11,9,SI,10,10,MUNICIPAL PROVINCIAL
349,9261,AVANZA PAIS - PARTIDO DE INTEGRACION SOCIAL,1,13,CHEPEN - LA LIBERTAD,2173,LA LIBERTAD,CHEPEN,,5,7,6,SI,3,10,MUNICIPAL PROVINCIAL
350,8364,MOVIMIENTO REGIONAL GANA AYACUCHO,1,12,LUCANAS - AYACUCHO,2694,AYACUCHO,LUCANAS,,5,7,5,SI,2,10,MUNICIPAL PROVINCIAL
351,4566,HATARIY APURIMAC,1,8,GRAU - APURIMAC,2886,APURIMAC,GRAU,,5,5,3,SI,2,6,MUNICIPAL PROVINCIAL
352,9234,ALIANZA LIBERTAD MADREDIOSENSE,1,14,TAMBOPATA - MADRE DE DIOS,2809,MADRE DE DIOS,TAMBOPATA,,5,7,7,SI,2,12,MUNICIPAL PROVINCIAL
353,9311,MOVIMIENTO REGIONAL WARI LLAQTA,1,11,VICTOR FAJARDO - AYACUCHO,2706,AYACUCHO,VICTOR FAJARDO,,5,6,5,SI,5,6,MUNICIPAL PROVINCIAL
354,3330,FUERZA INKA AMAZONICA,1,9,PARURO - CUSCO,2164,CUSCO,PARURO,,5,4,5,SI,1,8,MUNICIPAL PROVINCIAL
355,9313,PARTIDO DEMOCRATICO SOMOS PERU,1,6,ANTABAMBA - APURIMAC,14,APURIMAC,ANTABAMBA,,5,4,2,NO,0,6,MUNICIPAL PROVINCIAL
356,8942,AVANZA PAIS - PARTIDO DE INTEGRACION SOCIAL,1,18,TRUJILLO - LA LIBERTAD,2173,LA LIBERTAD,TRUJILLO,,5,10,8,SI,2,16,MUNICIPAL PROVINCIAL
357,4420,AVANZA PAIS - PARTIDO DE INTEGRACION SOCIAL,1,16,MOYOBAMBA - SAN MARTIN,2173,SAN MARTIN,MOYOBAMBA,,5,8,8,SI,4,12,MUNICIPAL PROVINCIAL
358,8952,LORETO PARA TODOS,1,17,MAYNAS - LORETO,2873,LORETO,MAYNAS,,5,9,8,SI,1,16,MUNICIPAL PROVINCIAL
359,678,SENTIMIENTO AMAZONENSE REGIONAL,1,12,BAGUA - AMAZONAS,2277,AMAZONAS,BAGUA,,5,6,6,SI,2,10,MUNICIPAL PROVINCIAL
360,5543,MOVIMIENTO REGIONAL AGUA,1,10,VILCAS HUAMAN - AYACUCHO,2861,AYACUCHO,VILCAS HUAMAN,,5,6,4,SI,4,6,MUNICIPAL PROVINCIAL
361,3325,FUERZA INKA AMAZONICA,1,12,CANAS - CUSCO,2164,CUSCO,CANAS,,5,6,6,SI,4,8,MUNICIPAL PROVINCIAL
362,9353,VICTORIA AMAZONENSE,1,14,LUYA - AMAZONAS,2878,AMAZONAS,LUYA,,5,8,6,SI,6,8,MUNICIPAL PROVINCIAL
363,3322,FUERZA INKA AMAZONICA,1,13,CALCA - CUSCO,2164,CUSCO,CALCA,,5,6,7,SI,3,10,MUNICIPAL PROVINCIAL
364,3320,FUERZA INKA AMAZONICA,1,13,ANTA - CUSCO,2164,CUSCO,ANTA,,5,6,7,SI,3,10,MUNICIPAL PROVINCIAL
365,9382,AREQUIPA - UNIDOS POR EL GRAN CAMBIO,1,12,ISLAY - AREQUIPA,2261,AREQUIPA,ISLAY,,5,7,5,SI,2,10,MUNICIPAL PROVINCIAL
366,9328,AVANZADA REGIONAL INDEPENDIENTE UNIDOS POR HUANUCO,1,8,YAROWILCA - HUANUCO,2201,HUANUCO,YAROWILCA,,5,4,4,SI,2,6,MUNICIPAL PROVINCIAL
367,4556,PARTIDO POLITICO NACIONAL PERU LIBRE,1,13,MORROPON - PIURA,2218,PIURA,MORROPON,,5,6,7,SI,1,12,MUNICIPAL PROVINCIAL
368,9443,PARTIDO DEMOCRATICO SOMOS PERU,1,14,ABANCAY - APURIMAC,14,APURIMAC,ABANCAY,,5,7,7,SI,2,12,MUNICIPAL PROVINCIAL
369,6964,AVANZA PAIS - PARTIDO DE INTEGRACION SOCIAL,1,13,MARISCAL CACERES - SAN MARTIN,2173,SAN MARTIN,MARISCAL CACERES,,5,7,6,SI,3,10,MUNICIPAL PROVINCIAL
370,9491,PASCO VERDE,1,14,DANIEL ALCIDES CARRION - PASCO,2353,PASCO,DANIEL ALCIDES CARRION,,5,8,6,SI,6,8,MUNICIPAL PROVINCIAL
371,6780,AVANZA PAIS - PARTIDO DE INTEGRACION SOCIAL,1,10,HUALLAGA - SAN MARTIN,2173,SAN MARTIN,HUALLAGA,,5,6,4,SI,2,8,MUNICIPAL PROVINCIAL
372,6198,AVANZA PAIS - PARTIDO DE INTEGRACION SOCIAL,1,10,TOCACHE - SAN MARTIN,2173,SAN MARTIN,TOCACHE,,5,6,4,NO,0,10,MUNICIPAL PROVINCIAL
373,6150,AVANZA PAIS - PARTIDO DE INTEGRACION SOCIAL,1,14,SAN MARTIN - SAN MARTIN,2173,SAN MARTIN,SAN MARTIN,,5,8,6,SI,2,12,MUNICIPAL PROVINCIAL
374,1433,MOVIMIENTO REGIONAL OBRAS POR LA MODERNIDAD,1,26,ICA - ICA,2244,ICA,ICA,,5,13,13,SI,12,14,MUNICIPAL PROVINCIAL
375,9581,ALIANZA POR NUESTRO DESARROLLO,1,11,VILCAS HUAMAN - AYACUCHO,2710,AYACUCHO,VILCAS HUAMAN,,5,6,5,SI,5,6,MUNICIPAL PROVINCIAL
376,7621,MOVIMIENTO ACCION NACIONALISTA PERUANO,1,14,HUAYLAS - ANCASH,360,ANCASH,HUAYLAS,,5,7,7,SI,4,10,MUNICIPAL PROVINCIAL
377,6064,MOVIMIENTO REGIONAL AYNI,1,12,CASTROVIRREYNA - HUANCAVELICA,136,HUANCAVELICA,CASTROVIRREYNA,,5,6,6,SI,6,6,MUNICIPAL PROVINCIAL
378,9618,TODOS POR EL GRAN CAMBIO,1,15,LEONCIO PRADO - HUANUCO,2712,HUANUCO,LEONCIO PRADO,,5,7,8,SI,3,12,MUNICIPAL PROVINCIAL
379,9638,PARTIDO POLITICO NACIONAL PERU LIBRE,1,10,ZARUMILLA - TUMBES,2218,TUMBES,ZARUMILLA,,5,5,5,NO,0,10,MUNICIPAL PROVINCIAL
380,9263,LORETO PARA TODOS,1,13,UCAYALI - LORETO,2873,LORETO,UCAYALI,,5,7,6,SI,3,10,MUNICIPAL PROVINCIAL
381,9697,MOVIMIENTO REGIONAL WARI LLAQTA,1,7,HUANCA SANCOS - AYACUCHO,2706,AYACUCHO,HUANCA SANCOS,,5,4,3,SI,1,6,MUNICIPAL PROVINCIAL
382,7334,MOVIMIENTO VERDE UNIDO,1,19,LAMBAYEQUE - LAMBAYEQUE,2343,LAMBAYEQUE,LAMBAYEQUE,,5,10,9,SI,5,14,MUNICIPAL PROVINCIAL
383,7178,MOVIMIENTO INDEPENDIENTE LORETO - MI LORETO,1,13,REQUENA - LORETO,315,LORETO,REQUENA,,5,7,6,SI,3,10,MUNICIPAL PROVINCIAL
384,9731,MOVIMIENTO REGIONAL WARI LLAQTA,1,9,PARINACOCHAS - AYACUCHO,2706,AYACUCHO,PARINACOCHAS,,5,5,4,SI,1,8,MUNICIPAL PROVINCIAL
385,7290,MOVIMIENTO INDEPENDIENTE LORETO - MI LORETO,1,13,UCAYALI - LORETO,315,LORETO,UCAYALI,,5,7,6,SI,3,10,MUNICIPAL PROVINCIAL
386,2450,AVANZA PAIS - PARTIDO DE INTEGRACION SOCIAL,1,16,HUANUCO - HUANUCO,2173,HUANUCO,HUANUCO,,5,9,7,SI,2,14,MUNICIPAL PROVINCIAL
387,5552,AVANZA PAIS - PARTIDO DE INTEGRACION SOCIAL,1,13,HUAMALIES - HUANUCO,2173,HUANUCO,HUAMALIES,,5,7,6,SI,3,10,MUNICIPAL PROVINCIAL
388,2783,CONCERTACION PARA EL DESARROLLO REGIONAL - LIMA,1,20,CAÑETE - LIMA,332,LIMA,CAÑETE,,5,10,10,SI,8,12,MUNICIPAL PROVINCIAL
389,4957,RENOVACION POPULAR,1,16,CAJAMARCA - CAJAMARCA,22,CAJAMARCA,CAJAMARCA,,5,9,7,SI,2,14,MUNICIPAL PROVINCIAL
390,9791,PARTIDO DEMOCRATICO SOMOS PERU,1,12,COTABAMBAS - APURIMAC,14,APURIMAC,COTABAMBAS,,5,7,5,SI,2,10,MUNICIPAL PROVINCIAL
391,4791,MOVIMIENTO REGIONAL AGUA,1,9,SUCRE - AYACUCHO,2861,AYACUCHO,SUCRE,,5,5,4,SI,3,6,MUNICIPAL PROVINCIAL
392,9819,SOCIOS POR ANCASH,1,10,ANTONIO RAIMONDI - ANCASH,2881,ANCASH,ANTONIO RAIMONDI,,5,5,5,SI,4,6,MUNICIPAL PROVINCIAL
393,9825,"FRENTE INDEPENDIENTE ALIANZA REGIONAL F.I.A.R.- ""NUEVA GENERACION """,1,10,PACHITEA - HUANUCO,2709,HUANUCO,PACHITEA,,5,5,5,NO,0,10,MUNICIPAL PROVINCIAL
394,9831,FUERZA INKA AMAZONICA,1,12,ACOMAYO - CUSCO,2164,CUSCO,ACOMAYO,,5,6,6,SI,6,6,MUNICIPAL PROVINCIAL
395,4614,AVANZA PAIS - PARTIDO DE INTEGRACION SOCIAL,1,13,DOS DE MAYO - HUANUCO,2173,HUANUCO,DOS DE MAYO,,5,7,6,SI,5,8,MUNICIPAL PROVINCIAL
396,7703,PATRIA JOVEN,1,8,YAUYOS - LIMA,553,LIMA,YAUYOS,,5,5,3,SI,2,6,MUNICIPAL PROVINCIAL
397,9706,MOVIMIENTO REGIONAL AGUA,1,12,PARINACOCHAS - AYACUCHO,2861,AYACUCHO,PARINACOCHAS,,5,7,5,SI,4,8,MUNICIPAL PROVINCIAL
398,7504,PATRIA JOVEN,1,8,CAJATAMBO - LIMA,553,LIMA,CAJATAMBO,,5,5,3,SI,2,6,MUNICIPAL PROVINCIAL
399,8238,PARTIDO DEMOCRATICO SOMOS PERU,1,12,TOCACHE - SAN MARTIN,14,SAN MARTIN,TOCACHE,,5,6,6,SI,2,10,MUNICIPAL PROVINCIAL
400,9882,PARTIDO DEMOCRATICO SOMOS PERU,1,6,OYON - LIMA,14,LIMA,OYON,,5,3,3,NO,0,6,MUNICIPAL PROVINCIAL
401,5431,ALIANZA GOBIERNO UNIDAD Y ACCION,1,19,CASMA - ANCASH,2856,ANCASH,CASMA,,5,10,9,SI,9,10,MUNICIPAL PROVINCIAL
402,9906,MOVIMIENTO REGIONAL EL MAICITO,1,10,HUARMEY - ANCASH,2245,ANCASH,HUARMEY,,5,6,4,SI,2,8,MUNICIPAL PROVINCIAL
403,9900,MOVIMIENTO REGIONAL AYNI,1,13,CHURCAMPA - HUANCAVELICA,136,HUANCAVELICA,CHURCAMPA,,5,7,6,SI,5,8,MUNICIPAL PROVINCIAL
404,9933,FRENTE POPULAR AGRICOLA FIA DEL PERU,1,14,ANTA - CUSCO,2901,CUSCO,ANTA,,5,7,7,SI,4,10,MUNICIPAL PROVINCIAL
405,9935,PARTIDO DEMOCRATICO SOMOS PERU,1,13,ASCOPE - LA LIBERTAD,14,LA LIBERTAD,ASCOPE,,5,7,6,SI,1,12,MUNICIPAL PROVINCIAL
406,9940,MOVIMIENTO REGIONAL EL MAICITO,1,16,CASMA - ANCASH,2245,ANCASH,CASMA,,5,9,7,SI,6,10,MUNICIPAL PROVINCIAL
407,3341,FRENTE POPULAR AGRICOLA FIA DEL PERU,1,11,ACOBAMBA - HUANCAVELICA,2901,HUANCAVELICA,ACOBAMBA,,5,6,5,SI,3,8,MUNICIPAL PROVINCIAL
408,9956,FRENTE POPULAR AGRICOLA FIA DEL PERU,1,12,ESPINAR - CUSCO,2901,CUSCO,ESPINAR,,5,5,7,SI,2,10,MUNICIPAL PROVINCIAL
409,9003,PARTIDO PATRIOTICO DEL PERU,1,13,PAITA - PIURA,2869,PIURA,PAITA,,5,7,6,SI,1,12,MUNICIPAL PROVINCIAL
410,9989,ORGANIZACION POLITICA UNIDAD REGIONAL,1,16,HUANCABAMBA - PIURA,2711,PIURA,HUANCABAMBA,,5,9,7,SI,4,12,MUNICIPAL PROVINCIAL
411,10008,PARTIDO MORADO,1,14,ANDAHUAYLAS - APURIMAC,2840,APURIMAC,ANDAHUAYLAS,,5,8,6,SI,2,12,MUNICIPAL PROVINCIAL
412,9992,PARTIDO PATRIOTICO DEL PERU,1,14,HUARAL - LIMA,2869,LIMA,HUARAL,,5,7,7,SI,2,12,MUNICIPAL PROVINCIAL
413,10046,FRENTE POPULAR AGRICOLA FIA DEL PERU,1,13,LA CONVENCION - CUSCO,2901,CUSCO,LA CONVENCION,,5,7,6,SI,1,12,MUNICIPAL PROVINCIAL
414,10054,FRENTE POPULAR AGRICOLA FIA DEL PERU,1,10,HUAMALIES - HUANUCO,2901,HUANUCO,HUAMALIES,,5,5,5,NO,0,10,MUNICIPAL PROVINCIAL
415,10059,FRENTE POPULAR AGRICOLA FIA DEL PERU,1,16,PIURA - PIURA,2901,PIURA,PIURA,,5,8,8,NO,0,16,MUNICIPAL PROVINCIAL
416,10066,FRENTE POPULAR AGRICOLA FIA DEL PERU,1,13,NASCA - ICA,2901,ICA,NASCA,,5,7,6,SI,3,10,MUNICIPAL PROVINCIAL
417,10074,AVANZA PAIS - PARTIDO DE INTEGRACION SOCIAL,1,17,LEONCIO PRADO - HUANUCO,2173,HUANUCO,LEONCIO PRADO,,5,9,8,SI,5,12,MUNICIPAL PROVINCIAL
418,6453,MOVIMIENTO REGIONAL OBRAS POR LA MODERNIDAD,1,16,NASCA - ICA,2244,ICA,NASCA,,5,9,7,SI,6,10,MUNICIPAL PROVINCIAL
419,4541,MOVIMIENTO REGIONAL OBRAS POR LA MODERNIDAD,1,21,CHINCHA - ICA,2244,ICA,CHINCHA,,5,11,10,SI,9,12,MUNICIPAL PROVINCIAL
420,10082,FRENTE REGIONAL DE CAJAMARCA,1,14,HUALGAYOC - CAJAMARCA,160,CAJAMARCA,HUALGAYOC,,5,7,7,SI,4,10,MUNICIPAL PROVINCIAL
421,5312,MOVIMIENTO INDEPENDIENTE REGIONAL HUANUCO PRIMERO,1,8,LAURICOCHA - HUANUCO,2162,HUANUCO,LAURICOCHA,,5,5,3,SI,2,6,MUNICIPAL PROVINCIAL
422,9776,MOVIMIENTO REGIONAL INKA PACHAKUTEQ,1,11,URUBAMBA - CUSCO,2368,CUSCO,URUBAMBA,,5,6,5,SI,1,10,MUNICIPAL PROVINCIAL
423,10147,FRENTE POPULAR AGRICOLA FIA DEL PERU,1,16,DOS DE MAYO - HUANUCO,2901,HUANUCO,DOS DE MAYO,,5,7,9,SI,8,8,MUNICIPAL PROVINCIAL
424,6620,GESTIONANDO OBRAS Y OPORTUNIDADES CON LIDERAZGO,2,16,SANDIA - PUNO,2667,PUNO,SANDIA,,5,9,7,SI,6,10,MUNICIPAL PROVINCIAL
425,10154,MOVIMIENTO REGIONAL INKA PACHAKUTEQ,1,10,ESPINAR - CUSCO,2368,CUSCO,ESPINAR,,5,6,4,NO,0,10,MUNICIPAL PROVINCIAL
426,10165,SOCIOS POR ANCASH,1,12,BOLOGNESI - ANCASH,2881,ANCASH,BOLOGNESI,,5,6,6,SI,6,6,MUNICIPAL PROVINCIAL
427,1678,MOVIMIENTO INDEPENDIENTE REGIONAL HUANUCO PRIMERO,1,8,YAROWILCA - HUANUCO,2162,HUANUCO,YAROWILCA,,5,4,4,SI,2,6,MUNICIPAL PROVINCIAL
428,10108,TODOS POR EL GRAN CAMBIO,1,13,HUAMALIES - HUANUCO,2712,HUANUCO,HUAMALIES,,5,7,6,SI,3,10,MUNICIPAL PROVINCIAL
429,10169,AVANZADA REGIONAL INDEPENDIENTE UNIDOS POR HUANUCO,1,14,HUAMALIES - HUANUCO,2201,HUANUCO,HUAMALIES,,5,7,7,SI,4,10,MUNICIPAL PROVINCIAL
430,10238,MOVIMIENTO REGIONAL INKA PACHAKUTEQ,1,13,LA CONVENCION - CUSCO,2368,CUSCO,LA CONVENCION,,5,7,6,SI,1,12,MUNICIPAL PROVINCIAL
431,10208,PARTIDO DEMOCRATICO SOMOS PERU,1,18,LAMBAYEQUE - LAMBAYEQUE,14,LAMBAYEQUE,LAMBAYEQUE,,5,10,8,SI,4,14,MUNICIPAL PROVINCIAL
432,10177,FRENTE POPULAR AGRICOLA FIA DEL PERU,1,16,LEONCIO PRADO - HUANUCO,2901,HUANUCO,LEONCIO PRADO,,5,8,8,SI,4,12,MUNICIPAL PROVINCIAL
433,946,FRENTE REGIONAL DE CAJAMARCA,1,12,SANTA CRUZ - CAJAMARCA,160,CAJAMARCA,SANTA CRUZ,,5,7,5,SI,4,8,MUNICIPAL PROVINCIAL
434,7129,PARTIDO POLITICO NACIONAL PERU LIBRE,1,12,HUANCA SANCOS - AYACUCHO,2218,AYACUCHO,HUANCA SANCOS,,5,7,5,SI,6,6,MUNICIPAL PROVINCIAL
435,10235,BANDERAS TACNEÑISTAS,1,6,CANDARAVE - TACNA,1600,TACNA,CANDARAVE,,5,3,3,NO,0,6,MUNICIPAL PROVINCIAL
436,10254,YO AREQUIPA,1,9,CARAVELI - AREQUIPA,2744,AREQUIPA,CARAVELI,,5,5,4,SI,1,8,MUNICIPAL PROVINCIAL
437,4601,PARTIDO POLITICO NACIONAL PERU LIBRE,1,15,PAITA - PIURA,2218,PIURA,PAITA,,5,8,7,SI,3,12,MUNICIPAL PROVINCIAL
438,1013,RENOVACION POPULAR,1,22,CALLAO - CALLAO,22,CALLAO,CALLAO,,5,11,11,SI,6,16,MUNICIPAL PROVINCIAL
439,10286,MOVIMIENTO REGIONAL SIERRA Y SELVA CONTIGO JUNIN,1,20,CHANCHAMAYO - JUNIN,2680,JUNIN,CHANCHAMAYO,,5,11,9,SI,8,12,MUNICIPAL PROVINCIAL
440,4185,ALIANZA GOBIERNO UNIDAD Y ACCION,1,13,HUARI - ANCASH,2856,ANCASH,HUARI,,5,7,6,SI,3,10,MUNICIPAL PROVINCIAL
441,10326,PARTIDO DEMOCRATICO SOMOS PERU,1,17,AREQUIPA - AREQUIPA,14,AREQUIPA,AREQUIPA,,5,9,8,SI,1,16,MUNICIPAL PROVINCIAL
442,10349,MOVIMIENTO REGIONAL UNIDAD CIVICA LIMA,1,15,BARRANCA - LIMA,2306,LIMA,BARRANCA,,5,8,7,SI,3,12,MUNICIPAL PROVINCIAL
443,5782,AVANZA PAIS - PARTIDO DE INTEGRACION SOCIAL,1,13,CAJABAMBA - CAJAMARCA,2173,CAJAMARCA,CAJABAMBA,,5,7,6,SI,3,10,MUNICIPAL PROVINCIAL
444,6634,AVANZA PAIS - PARTIDO DE INTEGRACION SOCIAL,1,12,SAN MARCOS - CAJAMARCA,2173,CAJAMARCA,SAN MARCOS,,5,7,5,SI,2,10,MUNICIPAL PROVINCIAL
445,7192,AVANZA PAIS - PARTIDO DE INTEGRACION SOCIAL,1,16,CUTERVO - CAJAMARCA,2173,CAJAMARCA,CUTERVO,,5,9,7,SI,4,12,MUNICIPAL PROVINCIAL
446,6868,AVANZA PAIS - PARTIDO DE INTEGRACION SOCIAL,1,10,LAMAS - SAN MARTIN,2173,SAN MARTIN,LAMAS,,5,6,4,NO,0,10,MUNICIPAL PROVINCIAL
447,10453,ALIANZA GOBIERNO UNIDAD Y ACCION,1,10,YUNGAY - ANCASH,2856,ANCASH,YUNGAY,,5,5,5,NO,0,10,MUNICIPAL PROVINCIAL
448,17,PODEMOS PERU,1,11,HUAYLAS - ANCASH,2731,ANCASH,HUAYLAS,,5,6,5,SI,1,10,MUNICIPAL PROVINCIAL
449,406,PODEMOS PERU,1,18,CALLAO - CALLAO,2731,CALLAO,CALLAO,,5,9,9,SI,2,16,MUNICIPAL PROVINCIAL
450,4144,PODEMOS PERU,1,16,SATIPO - JUNIN,2731,JUNIN,SATIPO,,5,8,8,SI,4,12,MUNICIPAL PROVINCIAL
451,3360,ALIADOS POR EL CAMBIO JUNIN,1,12,JAUJA - JUNIN,2879,JUNIN,JAUJA,,5,7,5,SI,2,10,MUNICIPAL PROVINCIAL
452,7038,RENOVACION POPULAR,1,10,CARAVELI - AREQUIPA,22,AREQUIPA,CARAVELI,,5,6,4,SI,2,8,MUNICIPAL PROVINCIAL
453,10346,MOVIMIENTO REGIONAL EL MAICITO,1,9,CARHUAZ - ANCASH,2245,ANCASH,CARHUAZ,,5,5,4,SI,1,8,MUNICIPAL PROVINCIAL
454,10493,BANDERAS TACNEÑISTAS,1,8,JORGE BASADRE - TACNA,1600,TACNA,JORGE BASADRE,,5,5,3,SI,2,6,MUNICIPAL PROVINCIAL
455,9293,TODOS SOMOS UCAYALI,1,12,ATALAYA - UCAYALI,1396,UCAYALI,ATALAYA,,5,6,6,SI,2,10,MUNICIPAL PROVINCIAL
456,10520,MOVIMIENTO REGIONAL INKA PACHAKUTEQ,1,10,CALCA - CUSCO,2368,CUSCO,CALCA,,5,4,6,NO,0,10,MUNICIPAL PROVINCIAL
457,7920,PATRIA JOVEN,1,12,HUAROCHIRI - LIMA,553,LIMA,HUAROCHIRI,,5,6,6,SI,2,10,MUNICIPAL PROVINCIAL
458,10086,MOVIMIENTO REGIONAL AYNI,1,23,HUANCAVELICA - HUANCAVELICA,136,HUANCAVELICA,HUANCAVELICA,,5,12,11,SI,11,12,MUNICIPAL PROVINCIAL
459,10380,PARTIDO DEMOCRATICO SOMOS PERU,1,8,GRAU - APURIMAC,14,APURIMAC,GRAU,,5,4,4,SI,2,6,MUNICIPAL PROVINCIAL
460,10517,MOVIMIENTO REGIONAL SIERRA Y SELVA CONTIGO JUNIN,1,10,JUNIN - JUNIN,2680,JUNIN,JUNIN,,5,5,5,SI,4,6,MUNICIPAL PROVINCIAL
461,6086,AVANZA PAIS - PARTIDO DE INTEGRACION SOCIAL,1,10,PICOTA - SAN MARTIN,2173,SAN MARTIN,PICOTA,,5,6,4,SI,2,8,MUNICIPAL PROVINCIAL
462,3332,FUERZA INKA AMAZONICA,1,11,QUISPICANCHI - CUSCO,2164,CUSCO,QUISPICANCHI,,5,6,5,SI,1,10,MUNICIPAL PROVINCIAL
463,10496,PODEMOS PERU,1,53,LIMA - LIMA,2731,LIMA,LIMA,,5,27,26,SI,13,40,MUNICIPAL PROVINCIAL
464,10677,AVANZA PAIS - PARTIDO DE INTEGRACION SOCIAL,1,8,LA UNION - AREQUIPA,2173,AREQUIPA,LA UNION,,5,5,3,SI,2,6,MUNICIPAL PROVINCIAL
465,10421,MOVIMIENTO REGIONAL INKA PACHAKUTEQ,1,13,ANTA - CUSCO,2368,CUSCO,ANTA,,5,7,6,SI,3,10,MUNICIPAL PROVINCIAL
466,10610,RENOVACION POPULAR,1,16,TACNA - TACNA,22,TACNA,TACNA,,5,8,8,SI,2,14,MUNICIPAL PROVINCIAL
467,7919,FUERZA POPULAR,1,10,AMBO - HUANUCO,1366,HUANUCO,AMBO,,5,5,5,NO,0,10,MUNICIPAL PROVINCIAL
468,7922,FUERZA POPULAR,1,10,PACHITEA - HUANUCO,1366,HUANUCO,PACHITEA,,5,5,5,NO,0,10,MUNICIPAL PROVINCIAL
469,7925,FUERZA POPULAR,1,10,JAUJA - JUNIN,1366,JUNIN,JAUJA,,5,5,5,NO,0,10,MUNICIPAL PROVINCIAL
470,7930,FUERZA POPULAR,1,12,SATIPO - JUNIN,1366,JUNIN,SATIPO,,5,7,5,NO,0,12,MUNICIPAL PROVINCIAL
471,5671,FE EN EL PERU,1,14,CAÑETE - LIMA,2898,LIMA,CAÑETE,,5,6,8,SI,2,12,MUNICIPAL PROVINCIAL
472,10734,PARTIDO MORADO,1,12,TOCACHE - SAN MARTIN,2840,SAN MARTIN,TOCACHE,,5,7,5,SI,2,10,MUNICIPAL PROVINCIAL
473,10712,MOVIMIENTO REGIONAL INKA PACHAKUTEQ,1,12,QUISPICANCHI - CUSCO,2368,CUSCO,QUISPICANCHI,,5,7,5,SI,2,10,MUNICIPAL PROVINCIAL
474,7900,FUERZA POPULAR,1,12,HUAURA - LIMA,1366,LIMA,HUAURA,,5,6,6,NO,0,12,MUNICIPAL PROVINCIAL
475,7865,FUERZA POPULAR,1,14,HUANUCO - HUANUCO,1366,HUANUCO,HUANUCO,,5,8,6,NO,0,14,MUNICIPAL PROVINCIAL
476,10757,RENOVACION POPULAR,1,14,LUYA - AMAZONAS,22,AMAZONAS,LUYA,,5,8,6,SI,6,8,MUNICIPAL PROVINCIAL
477,10283,"FRENTE INDEPENDIENTE ALIANZA REGIONAL F.I.A.R.- ""NUEVA GENERACION """,1,8,PUERTO INCA - HUANUCO,2709,HUANUCO,PUERTO INCA,,5,4,4,NO,0,8,MUNICIPAL PROVINCIAL
478,10791,KAUSACHUN,1,18,ILO - MOQUEGUA,2381,MOQUEGUA,ILO,,5,9,9,SI,8,10,MUNICIPAL PROVINCIAL
479,10153,MOVIMIENTO REGIONAL INKA PACHAKUTEQ,1,13,CHUMBIVILCAS - CUSCO,2368,CUSCO,CHUMBIVILCAS,,5,7,6,SI,3,10,MUNICIPAL PROVINCIAL
480,10822,"FRENTE INDEPENDIENTE ALIANZA REGIONAL F.I.A.R.- ""NUEVA GENERACION """,1,8,DOS DE MAYO - HUANUCO,2709,HUANUCO,DOS DE MAYO,,5,5,3,NO,0,8,MUNICIPAL PROVINCIAL
481,10803,TODOS SOMOS UCAYALI,1,12,PADRE ABAD - UCAYALI,1396,UCAYALI,PADRE ABAD,,5,6,6,SI,2,10,MUNICIPAL PROVINCIAL
482,10840,"FRENTE INDEPENDIENTE ALIANZA REGIONAL F.I.A.R.- ""NUEVA GENERACION """,1,10,HUAMALIES - HUANUCO,2709,HUANUCO,HUAMALIES,,5,6,4,NO,0,10,MUNICIPAL PROVINCIAL
483,10851,"FRENTE INDEPENDIENTE ALIANZA REGIONAL F.I.A.R.- ""NUEVA GENERACION """,1,6,LAURICOCHA - HUANUCO,2709,HUANUCO,LAURICOCHA,,5,3,3,NO,0,6,MUNICIPAL PROVINCIAL
484,3018,RENOVACION POPULAR,1,14,SANTIAGO DE CHUCO - LA LIBERTAD,22,LA LIBERTAD,SANTIAGO DE CHUCO,,5,8,6,SI,4,10,MUNICIPAL PROVINCIAL
485,10865,"FRENTE INDEPENDIENTE ALIANZA REGIONAL F.I.A.R.- ""NUEVA GENERACION """,1,12,LEONCIO PRADO - HUANUCO,2709,HUANUCO,LEONCIO PRADO,,5,6,6,NO,0,12,MUNICIPAL PROVINCIAL
486,10869,AVANZA PAIS - PARTIDO DE INTEGRACION SOCIAL,1,6,CAJATAMBO - LIMA,2173,LIMA,CAJATAMBO,,5,4,2,NO,0,6,MUNICIPAL PROVINCIAL
487,10884,"FRENTE INDEPENDIENTE ALIANZA REGIONAL F.I.A.R.- ""NUEVA GENERACION """,1,6,YAROWILCA - HUANUCO,2709,HUANUCO,YAROWILCA,,5,4,2,NO,0,6,MUNICIPAL PROVINCIAL
488,10860,PARTIDO DEMOCRATICO SOMOS PERU,1,10,AYMARAES - APURIMAC,14,APURIMAC,AYMARAES,,5,6,4,SI,2,8,MUNICIPAL PROVINCIAL
489,10889,ALIANZA POR NUESTRO DESARROLLO,1,15,CANGALLO - AYACUCHO,2710,AYACUCHO,CANGALLO,,5,8,7,SI,7,8,MUNICIPAL PROVINCIAL
490,10816,MOVIMIENTO REGIONAL BICENTENARIO,1,13,ASCOPE - LA LIBERTAD,2906,LA LIBERTAD,ASCOPE,,5,6,7,SI,1,12,MUNICIPAL PROVINCIAL
491,10925,SOCIOS POR ANCASH,1,6,CORONGO - ANCASH,2881,ANCASH,CORONGO,,5,4,2,NO,0,6,MUNICIPAL PROVINCIAL
492,10943,"FRENTE INDEPENDIENTE ALIANZA REGIONAL F.I.A.R.- ""NUEVA GENERACION """,1,10,AMBO - HUANUCO,2709,HUANUCO,AMBO,,5,6,4,NO,0,10,MUNICIPAL PROVINCIAL
493,1077,SENTIMIENTO AMAZONENSE REGIONAL,1,10,BONGARA - AMAZONAS,2277,AMAZONAS,BONGARA,,5,5,5,SI,2,8,MUNICIPAL PROVINCIAL
494,9165,PARTIDO DEMOCRATICO SOMOS PERU,1,16,SATIPO - JUNIN,14,JUNIN,SATIPO,,5,8,8,SI,4,12,MUNICIPAL PROVINCIAL
495,10730,PARTIDO PATRIOTICO DEL PERU,1,15,SANCHEZ CARRION - LA LIBERTAD,2869,LA LIBERTAD,SANCHEZ CARRION,,5,8,7,SI,3,12,MUNICIPAL PROVINCIAL
496,11040,SOCIOS POR ANCASH,1,12,YUNGAY - ANCASH,2881,ANCASH,YUNGAY,,5,6,6,SI,2,10,MUNICIPAL PROVINCIAL
497,10974,NUESTRO ILO - MOQUEGUA - SANCHEZ CERRO,1,14,ILO - MOQUEGUA,2497,MOQUEGUA,ILO,,5,8,6,SI,4,10,MUNICIPAL PROVINCIAL
498,11053,CAMINEMOS JUNTOS POR JUNIN,1,8,JUNIN - JUNIN,122,JUNIN,JUNIN,,5,5,3,SI,2,6,MUNICIPAL PROVINCIAL
499,8787,MOVIMIENTO REGIONAL SIERRA Y SELVA CONTIGO JUNIN,1,18,CHUPACA - JUNIN,2680,JUNIN,CHUPACA,,5,10,8,SI,8,10,MUNICIPAL PROVINCIAL
500,10926,PARTIDO POLITICO NACIONAL PERU LIBRE,1,21,ANDAHUAYLAS - APURIMAC,2218,APURIMAC,ANDAHUAYLAS,,5,11,10,SI,9,12,MUNICIPAL PROVINCIAL
501,10848,MOVIMIENTO REGIONAL FUERZA POR MADRE DE DIOS - MR FMDD,1,13,MANU - MADRE DE DIOS,2300,MADRE DE DIOS,MANU,,5,7,6,SI,7,6,MUNICIPAL PROVINCIAL
502,11050,CONCERTACION PARA EL DESARROLLO REGIONAL - LIMA,1,15,BARRANCA - LIMA,332,LIMA,BARRANCA,,5,8,7,SI,3,12,MUNICIPAL PROVINCIAL
503,10984,FUERZA LORETANA,1,10,UCAYALI - LORETO,61,LORETO,UCAYALI,,5,6,4,NO,0,10,MUNICIPAL PROVINCIAL
504,11103,PARTIDO DEMOCRATICO SOMOS PERU,1,9,BOLOGNESI - ANCASH,14,ANCASH,BOLOGNESI,,5,5,4,SI,3,6,MUNICIPAL PROVINCIAL
505,10683,PARTIDO POLITICO NACIONAL PERU LIBRE,1,12,GENERAL SANCHEZ CERRO - MOQUEGUA,2218,MOQUEGUA,GENERAL SANCHEZ CERRO,,5,6,6,SI,6,6,MUNICIPAL PROVINCIAL
506,9972,PARTIDO DEMOCRATICO SOMOS PERU,1,18,CHEPEN - LA LIBERTAD,14,LA LIBERTAD,CHEPEN,,5,10,8,SI,8,10,MUNICIPAL PROVINCIAL
507,11104,AVANZA PAIS - PARTIDO DE INTEGRACION SOCIAL,1,15,RIOJA - SAN MARTIN,2173,SAN MARTIN,RIOJA,,5,8,7,SI,3,12,MUNICIPAL PROVINCIAL
508,929,MOVIMIENTO INDEPENDIENTE REGIONAL HUANUCO PRIMERO,1,14,AMBO - HUANUCO,2162,HUANUCO,AMBO,,5,8,6,SI,4,10,MUNICIPAL PROVINCIAL
509,11130,PARTIDO DEMOCRATICO SOMOS PERU,1,16,HUARAL - LIMA,14,LIMA,HUARAL,,5,9,7,SI,4,12,MUNICIPAL PROVINCIAL
510,723,NUESTRO ILO - MOQUEGUA - SANCHEZ CERRO,1,7,GENERAL SANCHEZ CERRO - MOQUEGUA,2497,MOQUEGUA,GENERAL SANCHEZ CERRO,,5,3,4,SI,1,6,MUNICIPAL PROVINCIAL
511,812,CAMINEMOS JUNTOS POR JUNIN,1,18,CHUPACA - JUNIN,122,JUNIN,CHUPACA,,5,10,8,SI,8,10,MUNICIPAL PROVINCIAL
512,11158,RENOVACION POPULAR,1,8,JUNIN - JUNIN,22,JUNIN,JUNIN,,5,4,4,SI,2,6,MUNICIPAL PROVINCIAL
513,11125,CONCERTACION PARA EL DESARROLLO REGIONAL - LIMA,1,7,CAJATAMBO - LIMA,332,LIMA,CAJATAMBO,,5,4,3,SI,1,6,MUNICIPAL PROVINCIAL
514,9394,JUNTOS POR EL PERU,1,10,POMABAMBA - ANCASH,1264,ANCASH,POMABAMBA,,5,5,5,SI,2,8,MUNICIPAL PROVINCIAL
515,668,SENTIMIENTO AMAZONENSE REGIONAL,1,11,LUYA - AMAZONAS,2277,AMAZONAS,LUYA,,5,6,5,SI,3,8,MUNICIPAL PROVINCIAL
516,6764,PARTIDO DEMOCRATICO SOMOS PERU,1,18,RIOJA - SAN MARTIN,14,SAN MARTIN,RIOJA,,5,10,8,SI,6,12,MUNICIPAL PROVINCIAL
517,9153,AREQUIPA RENACE,1,14,CAMANA - AREQUIPA,443,AREQUIPA,CAMANA,,5,7,7,SI,4,10,MUNICIPAL PROVINCIAL
518,10838,MOVIMIENTO REGIONAL INKA PACHAKUTEQ,1,20,CUSCO - CUSCO,2368,CUSCO,CUSCO,,5,11,9,SI,6,14,MUNICIPAL PROVINCIAL
519,11211,ACCION REGIONAL,1,12,SAN MARTIN - SAN MARTIN,131,SAN MARTIN,SAN MARTIN,,5,6,6,NO,0,12,MUNICIPAL PROVINCIAL
520,11231,MOVIMIENTO REGIONAL UNIDAD CIVICA LIMA,1,8,CAJATAMBO - LIMA,2306,LIMA,CAJATAMBO,,5,5,3,SI,2,6,MUNICIPAL PROVINCIAL
521,9655,JUNTOS POR EL PERU,1,9,SIHUAS - ANCASH,1264,ANCASH,SIHUAS,,5,5,4,SI,1,8,MUNICIPAL PROVINCIAL
522,11229,BANDERAS TACNEÑISTAS,1,25,TACNA - TACNA,1600,TACNA,TACNA,,5,13,12,SI,11,14,MUNICIPAL PROVINCIAL
523,11207,PARTIDO PATRIOTICO DEL PERU,1,17,TACNA - TACNA,2869,TACNA,TACNA,,5,9,8,SI,3,14,MUNICIPAL PROVINCIAL
524,9687,JUNTOS POR EL PERU,1,11,CASMA - ANCASH,1264,ANCASH,CASMA,,5,6,5,SI,1,10,MUNICIPAL PROVINCIAL
525,9748,JUNTOS POR EL PERU,1,8,CARLOS FERMIN FITZCARRALD - ANCASH,1264,ANCASH,CARLOS FERMIN FITZCARRALD,,5,5,3,SI,2,6,MUNICIPAL PROVINCIAL
526,9963,JUNTOS POR EL PERU,1,11,HUARI - ANCASH,1264,ANCASH,HUARI,,5,6,5,SI,1,10,MUNICIPAL PROVINCIAL
527,7522,ALIANZA GOBIERNO UNIDAD Y ACCION,1,11,BOLOGNESI - ANCASH,2856,ANCASH,BOLOGNESI,,5,5,6,SI,5,6,MUNICIPAL PROVINCIAL
528,9600,JUNTOS POR EL PERU,1,6,ANTONIO RAIMONDI - ANCASH,1264,ANCASH,ANTONIO RAIMONDI,,5,4,2,NO,0,6,MUNICIPAL PROVINCIAL
529,9456,JUNTOS POR EL PERU,1,12,HUAYLAS - ANCASH,1264,ANCASH,HUAYLAS,,5,6,6,SI,2,10,MUNICIPAL PROVINCIAL
530,9915,SOCIOS POR ANCASH,1,8,CARLOS FERMIN FITZCARRALD - ANCASH,2881,ANCASH,CARLOS FERMIN FITZCARRALD,,5,5,3,SI,2,6,MUNICIPAL PROVINCIAL
531,9076,MOVIMIENTO INDEPENDIENTE AMOR POR MADRE DE DIOS,1,23,TAMBOPATA - MADRE DE DIOS,1441,MADRE DE DIOS,TAMBOPATA,,5,11,12,SI,11,12,MUNICIPAL PROVINCIAL
532,9560,JUNTOS POR EL PERU,1,8,ASUNCION - ANCASH,1264,ANCASH,ASUNCION,,5,5,3,SI,2,6,MUNICIPAL PROVINCIAL
533,11315,FRENTE POPULAR AGRICOLA FIA DEL PERU,1,11,HUANTA - AYACUCHO,2901,AYACUCHO,HUANTA,,5,6,5,SI,1,10,MUNICIPAL PROVINCIAL
534,11275,PARTIDO DEMOCRATICO SOMOS PERU,1,10,HUAROCHIRI - LIMA,14,LIMA,HUAROCHIRI,,5,5,5,NO,0,10,MUNICIPAL PROVINCIAL
535,9930,JUNTOS POR EL PERU,1,8,AIJA - ANCASH,1264,ANCASH,AIJA,,5,5,3,SI,2,6,MUNICIPAL PROVINCIAL
536,11323,FRENTE POPULAR AGRICOLA FIA DEL PERU,1,10,TAHUAMANU - MADRE DE DIOS,2901,MADRE DE DIOS,TAHUAMANU,,5,5,5,SI,4,6,MUNICIPAL PROVINCIAL
537,9139,JUNTOS POR EL PERU,1,11,HUARMEY - ANCASH,1264,ANCASH,HUARMEY,,5,6,5,SI,3,8,MUNICIPAL PROVINCIAL
538,11320,RENOVACION POPULAR,1,25,TAMBOPATA - MADRE DE DIOS,22,MADRE DE DIOS,TAMBOPATA,,5,13,12,SI,13,12,MUNICIPAL PROVINCIAL
539,11319,PARTIDO DEMOCRATICO SOMOS PERU,1,15,PACASMAYO - LA LIBERTAD,14,LA LIBERTAD,PACASMAYO,,5,8,7,SI,3,12,MUNICIPAL PROVINCIAL
540,9721,JUNTOS POR EL PERU,1,7,MARISCAL LUZURIAGA - ANCASH,1264,ANCASH,MARISCAL LUZURIAGA,,5,4,3,SI,1,6,MUNICIPAL PROVINCIAL
541,9250,JUNTOS POR EL PERU,1,11,YUNGAY - ANCASH,1264,ANCASH,YUNGAY,,5,6,5,SI,1,10,MUNICIPAL PROVINCIAL
542,9243,MOVIMIENTO INDEPENDIENTE AMOR POR MADRE DE DIOS,1,11,TAHUAMANU - MADRE DE DIOS,1441,MADRE DE DIOS,TAHUAMANU,,5,6,5,SI,5,6,MUNICIPAL PROVINCIAL
543,11359,FRENTE POPULAR AGRICOLA FIA DEL PERU,1,22,CUSCO - CUSCO,2901,CUSCO,CUSCO,,5,11,11,SI,8,14,MUNICIPAL PROVINCIAL
544,11341,ACCION REGIONAL,1,16,MARISCAL CACERES - SAN MARTIN,131,SAN MARTIN,MARISCAL CACERES,,5,9,7,SI,6,10,MUNICIPAL PROVINCIAL
545,8595,JUNTOS POR EL PERU,1,16,HUARAZ - ANCASH,1264,ANCASH,HUARAZ,,5,9,7,SI,4,12,MUNICIPAL PROVINCIAL
546,9155,JUNTOS POR EL PERU,1,9,CARHUAZ - ANCASH,1264,ANCASH,CARHUAZ,,5,5,4,SI,1,8,MUNICIPAL PROVINCIAL
547,11384,SUMATE,1,12,CHEPEN - LA LIBERTAD,67,LA LIBERTAD,CHEPEN,,5,6,6,SI,2,10,MUNICIPAL PROVINCIAL
548,11439,RENOVACION POPULAR,1,15,BARRANCA - LIMA,22,LIMA,BARRANCA,,5,8,7,SI,3,12,MUNICIPAL PROVINCIAL
549,9499,JUNTOS POR EL PERU,1,8,PALLASCA - ANCASH,1264,ANCASH,PALLASCA,,5,5,3,NO,0,8,MUNICIPAL PROVINCIAL
550,9790,JUNTOS POR EL PERU,1,12,LEONCIO PRADO - HUANUCO,1264,HUANUCO,LEONCIO PRADO,,5,6,6,NO,0,12,MUNICIPAL PROVINCIAL
551,10754,PARTIDO MORADO,1,15,SAN MARTIN - SAN MARTIN,2840,SAN MARTIN,SAN MARTIN,,5,8,7,SI,3,12,MUNICIPAL PROVINCIAL
552,11462,RENOVACION POPULAR,1,15,HUAURA - LIMA,22,LIMA,HUAURA,,5,8,7,SI,3,12,MUNICIPAL PROVINCIAL
553,8098,ACCION POPULAR,1,14,CHINCHA - ICA,4,ICA,CHINCHA,,5,7,7,SI,2,12,MUNICIPAL PROVINCIAL
554,10225,PARTIDO POLITICO NACIONAL PERU LIBRE,1,11,ACOBAMBA - HUANCAVELICA,2218,HUANCAVELICA,ACOBAMBA,,5,6,5,SI,3,8,MUNICIPAL PROVINCIAL
555,9916,JUNTOS POR EL PERU,1,7,HUACAYBAMBA - HUANUCO,1264,HUANUCO,HUACAYBAMBA,,5,4,3,SI,1,6,MUNICIPAL PROVINCIAL
556,11469,UNO POR ICA,1,6,PALPA - ICA,2701,ICA,PALPA,,5,4,2,NO,0,6,MUNICIPAL PROVINCIAL
557,7967,FUERZA POPULAR,1,12,LEONCIO PRADO - HUANUCO,1366,HUANUCO,LEONCIO PRADO,,5,7,5,NO,0,12,MUNICIPAL PROVINCIAL
558,9435,JUNTOS POR EL PERU,1,7,CORONGO - ANCASH,1264,ANCASH,CORONGO,,5,4,3,SI,1,6,MUNICIPAL PROVINCIAL
559,7862,REFORMA Y HONRADEZ POR MAS OBRAS,1,20,AZANGARO - PUNO,2912,PUNO,AZANGARO,,5,11,9,SI,8,12,MUNICIPAL PROVINCIAL
560,11513,SOMOS PUEBLO,1,18,MELGAR - PUNO,2657,PUNO,MELGAR,,5,9,9,SI,8,10,MUNICIPAL PROVINCIAL
561,9711,JUNTOS POR EL PERU,1,9,BOLOGNESI - ANCASH,1264,ANCASH,BOLOGNESI,,5,5,4,SI,3,6,MUNICIPAL PROVINCIAL
562,4473,JUNIN SOSTENIBLE CON SU GENTE,1,14,SATIPO - JUNIN,303,JUNIN,SATIPO,,5,8,6,SI,2,12,MUNICIPAL PROVINCIAL
563,10452,AVANZA PAIS - PARTIDO DE INTEGRACION SOCIAL,1,20,TACNA - TACNA,2173,TACNA,TACNA,,5,10,10,SI,6,14,MUNICIPAL PROVINCIAL
564,107,PODEMOS PERU,1,8,PURUS - UCAYALI,2731,UCAYALI,PURUS,,5,4,4,SI,2,6,MUNICIPAL PROVINCIAL
565,121,PODEMOS PERU,1,12,PADRE ABAD - UCAYALI,2731,UCAYALI,PADRE ABAD,,5,6,6,SI,2,10,MUNICIPAL PROVINCIAL
566,9857,JUNTOS POR EL PERU,1,10,YAROWILCA - HUANUCO,1264,HUANUCO,YAROWILCA,,5,6,4,SI,4,6,MUNICIPAL PROVINCIAL
567,115,PODEMOS PERU,1,18,CORONEL PORTILLO - UCAYALI,2731,UCAYALI,CORONEL PORTILLO,,5,9,9,SI,4,14,MUNICIPAL PROVINCIAL
568,122,PODEMOS PERU,1,12,ATALAYA - UCAYALI,2731,UCAYALI,ATALAYA,,5,6,6,SI,2,10,MUNICIPAL PROVINCIAL
569,9828,JUNTOS POR EL PERU,1,9,MARAÑON - HUANUCO,1264,HUANUCO,MARAÑON,,5,5,4,SI,1,8,MUNICIPAL PROVINCIAL
570,9807,JUNTOS POR EL PERU,1,16,HUANUCO - HUANUCO,1264,HUANUCO,HUANUCO,,5,8,8,SI,2,14,MUNICIPAL PROVINCIAL
571,11615,NUEVA LIBERTAD,1,12,CHEPEN - LA LIBERTAD,2232,LA LIBERTAD,CHEPEN,,5,5,7,SI,2,10,MUNICIPAL PROVINCIAL
572,9800,JUNTOS POR EL PERU,1,11,PUERTO INCA - HUANUCO,1264,HUANUCO,PUERTO INCA,,5,6,5,SI,3,8,MUNICIPAL PROVINCIAL
573,1276,RENOVACION POPULAR,1,12,BONGARA - AMAZONAS,22,AMAZONAS,BONGARA,,5,7,5,SI,4,8,MUNICIPAL PROVINCIAL
574,547,PODEMOS PERU,1,24,TACNA - TACNA,2731,TACNA,TACNA,,5,13,11,SI,10,14,MUNICIPAL PROVINCIAL
575,11634,JUNTOS POR EL DESARROLLO DE AREQUIPA,1,7,LA UNION - AREQUIPA,2257,AREQUIPA,LA UNION,,5,4,3,SI,1,6,MUNICIPAL PROVINCIAL
576,669,PODEMOS PERU,1,12,TOCACHE - SAN MARTIN,2731,SAN MARTIN,TOCACHE,,5,7,5,SI,2,10,MUNICIPAL PROVINCIAL
577,11447,MISION ORGANIZADA VIA INTEGRIDAD Y LIBERTAD,3,21,MAYNAS - LORETO,2907,LORETO,MAYNAS,,5,10,11,SI,5,16,MUNICIPAL PROVINCIAL
578,11497,PARTIDO PATRIOTICO DEL PERU,1,14,TUMBES - TUMBES,2869,TUMBES,TUMBES,,5,7,7,SI,2,12,MUNICIPAL PROVINCIAL
579,9983,PARTIDO DEMOCRATICO SOMOS PERU,1,15,SANTIAGO DE CHUCO - LA LIBERTAD,14,LA LIBERTAD,SANTIAGO DE CHUCO,,5,8,7,SI,5,10,MUNICIPAL PROVINCIAL
580,9879,FUERZA POPULAR,1,12,BARRANCA - LIMA,1366,LIMA,BARRANCA,,5,6,6,NO,0,12,MUNICIPAL PROVINCIAL
581,11644,PARTIDO POLITICO NACIONAL PERU LIBRE,1,10,YAULI - JUNIN,2218,JUNIN,YAULI,,5,5,5,SI,2,8,MUNICIPAL PROVINCIAL
582,9860,FUERZA POPULAR,1,6,CANTA - LIMA,1366,LIMA,CANTA,,5,3,3,NO,0,6,MUNICIPAL PROVINCIAL
583,11584,JUNTOS POR EL DESARROLLO DE AREQUIPA,1,8,CONDESUYOS - AREQUIPA,2257,AREQUIPA,CONDESUYOS,,5,5,3,SI,2,6,MUNICIPAL PROVINCIAL
584,10462,JUNTOS POR EL PERU,1,22,VIRU - LA LIBERTAD,1264,LA LIBERTAD,VIRU,,5,11,11,SI,12,10,MUNICIPAL PROVINCIAL
585,10363,JUNTOS POR EL PERU,1,10,CHEPEN - LA LIBERTAD,1264,LA LIBERTAD,CHEPEN,,5,6,4,NO,0,10,MUNICIPAL PROVINCIAL
586,698,PODEMOS PERU,1,11,MARISCAL CACERES - SAN MARTIN,2731,SAN MARTIN,MARISCAL CACERES,,5,6,5,SI,1,10,MUNICIPAL PROVINCIAL
587,11750,MOVIMIENTO REGIONAL AREQUIPA AVANCEMOS,1,8,LA UNION - AREQUIPA,2307,AREQUIPA,LA UNION,,5,4,4,SI,2,6,MUNICIPAL PROVINCIAL
588,2570,PODEMOS PERU,1,10,EL DORADO - SAN MARTIN,2731,SAN MARTIN,EL DORADO,,5,6,4,SI,2,8,MUNICIPAL PROVINCIAL
589,11695,PARTIDO POLITICO NACIONAL PERU LIBRE,1,12,AYMARAES - APURIMAC,2218,APURIMAC,AYMARAES,,5,6,6,SI,4,8,MUNICIPAL PROVINCIAL
590,550,PODEMOS PERU,1,18,TALARA - PIURA,2731,PIURA,TALARA,,5,10,8,SI,6,12,MUNICIPAL PROVINCIAL
591,11772,ACCION REGIONAL,1,16,MOYOBAMBA - SAN MARTIN,131,SAN MARTIN,MOYOBAMBA,,5,9,7,SI,4,12,MUNICIPAL PROVINCIAL
592,11764,RENOVACION POPULAR,1,13,HUARMEY - ANCASH,22,ANCASH,HUARMEY,,5,7,6,SI,5,8,MUNICIPAL PROVINCIAL
593,481,PODEMOS PERU,1,11,ILO - MOQUEGUA,2731,MOQUEGUA,ILO,,5,6,5,SI,1,10,MUNICIPAL PROVINCIAL
594,8075,PODEMOS PERU,1,10,TAHUAMANU - MADRE DE DIOS,2731,MADRE DE DIOS,TAHUAMANU,,5,5,5,SI,4,6,MUNICIPAL PROVINCIAL
595,3844,PODEMOS PERU,1,6,MANU - MADRE DE DIOS,2731,MADRE DE DIOS,MANU,,5,3,3,NO,0,6,MUNICIPAL PROVINCIAL
596,10076,AVANZA PAIS - PARTIDO DE INTEGRACION SOCIAL,1,13,PACHITEA - HUANUCO,2173,HUANUCO,PACHITEA,,5,7,6,SI,3,10,MUNICIPAL PROVINCIAL
597,11859,PARTIDO DEMOCRATICO SOMOS PERU,1,8,PUERTO INCA - HUANUCO,14,HUANUCO,PUERTO INCA,,5,5,3,NO,0,8,MUNICIPAL PROVINCIAL
598,345,PODEMOS PERU,1,20,MAYNAS - LORETO,2731,LORETO,MAYNAS,,5,11,9,SI,4,16,MUNICIPAL PROVINCIAL
599,11846,PARTIDO PATRIOTICO DEL PERU,1,19,CHICLAYO - LAMBAYEQUE,2869,LAMBAYEQUE,CHICLAYO,,5,10,9,SI,3,16,MUNICIPAL PROVINCIAL
600,359,PODEMOS PERU,1,7,OYON - LIMA,2731,LIMA,OYON,,5,4,3,SI,1,6,MUNICIPAL PROVINCIAL
601,7855,RENOVACION POPULAR,1,12,PACASMAYO - LA LIBERTAD,22,LA LIBERTAD,PACASMAYO,,5,7,5,NO,0,12,MUNICIPAL PROVINCIAL
602,374,PODEMOS PERU,1,15,HUAURA - LIMA,2731,LIMA,HUAURA,,5,8,7,SI,3,12,MUNICIPAL PROVINCIAL
603,5778,JUNIN SOSTENIBLE CON SU GENTE,1,11,YAULI - JUNIN,303,JUNIN,YAULI,,5,6,5,SI,3,8,MUNICIPAL PROVINCIAL
604,11863,PASCO UNIDO,1,16,PASCO - PASCO,2725,PASCO,PASCO,,5,9,7,SI,4,12,MUNICIPAL PROVINCIAL
605,10451,RENOVACION TUMBESINA,1,6,CONTRALMIRANTE VILLAR - TUMBES,2171,TUMBES,CONTRALMIRANTE VILLAR,,5,3,3,NO,0,6,MUNICIPAL PROVINCIAL
606,11879,AVANZA PAIS - PARTIDO DE INTEGRACION SOCIAL,1,6,OCROS - ANCASH,2173,ANCASH,OCROS,,5,3,3,NO,0,6,MUNICIPAL PROVINCIAL
607,411,PODEMOS PERU,1,16,HUARAL - LIMA,2731,LIMA,HUARAL,,5,8,8,SI,4,12,MUNICIPAL PROVINCIAL
608,437,PODEMOS PERU,1,13,CAÑETE - LIMA,2731,LIMA,CAÑETE,,5,7,6,SI,1,12,MUNICIPAL PROVINCIAL
609,11940,JUNTOS POR LORETO,1,10,DATEM DEL MARAÑON - LORETO,2871,LORETO,DATEM DEL MARAÑON,,5,6,4,NO,0,10,MUNICIPAL PROVINCIAL
610,7820,FUERZA POPULAR,1,20,CALLAO - CALLAO,1366,CALLAO,CALLAO,,5,10,10,SI,4,16,MUNICIPAL PROVINCIAL
611,5575,FE EN EL PERU,1,13,HUANCAVELICA - HUANCAVELICA,2898,HUANCAVELICA,HUANCAVELICA,,5,6,7,SI,1,12,MUNICIPAL PROVINCIAL
612,11907,PARTIDO PATRIOTICO DEL PERU,2,12,TUMBES - TUMBES,2869,TUMBES,TUMBES,,5,7,5,NO,0,12,MUNICIPAL PROVINCIAL
613,451,PODEMOS PERU,1,16,BARRANCA - LIMA,2731,LIMA,BARRANCA,,5,9,7,SI,4,12,MUNICIPAL PROVINCIAL
614,11931,PASCO UNIDO,1,11,DANIEL ALCIDES CARRION - PASCO,2725,PASCO,DANIEL ALCIDES CARRION,,5,6,5,SI,3,8,MUNICIPAL PROVINCIAL
615,6209,PARTIDO DEMOCRATICO SOMOS PERU,1,12,PASCO - PASCO,14,PASCO,PASCO,,5,7,5,NO,0,12,MUNICIPAL PROVINCIAL
616,876,PODEMOS PERU,1,20,TRUJILLO - LA LIBERTAD,2731,LA LIBERTAD,TRUJILLO,,5,10,10,SI,4,16,MUNICIPAL PROVINCIAL
617,3417,PODEMOS PERU,1,9,GRAN CHIMU - LA LIBERTAD,2731,LA LIBERTAD,GRAN CHIMU,,5,4,5,SI,1,8,MUNICIPAL PROVINCIAL
618,5293,AVANZA PAIS - PARTIDO DE INTEGRACION SOCIAL,1,14,FERREÑAFE - LAMBAYEQUE,2173,LAMBAYEQUE,FERREÑAFE,,5,7,7,SI,2,12,MUNICIPAL PROVINCIAL
619,11643,RENOVACION TUMBESINA,1,17,TUMBES - TUMBES,2171,TUMBES,TUMBES,,5,9,8,SI,5,12,MUNICIPAL PROVINCIAL
620,11419,PARTIDO DEMOCRATICO SOMOS PERU,1,18,ANDAHUAYLAS - APURIMAC,14,APURIMAC,ANDAHUAYLAS,,5,10,8,SI,6,12,MUNICIPAL PROVINCIAL
621,11983,AVANZA PAIS - PARTIDO DE INTEGRACION SOCIAL,1,14,TUMBES - TUMBES,2173,TUMBES,TUMBES,,5,7,7,SI,2,12,MUNICIPAL PROVINCIAL
622,7131,MOVIMIENTO INDEPENDIENTE LORETO - MI LORETO,1,13,MARISCAL RAMON CASTILLA - LORETO,315,LORETO,MARISCAL RAMON CASTILLA,,5,7,6,SI,3,10,MUNICIPAL PROVINCIAL
623,6452,MOVIMIENTO REGIONAL OBRAS POR LA MODERNIDAD,1,18,PISCO - ICA,2244,ICA,PISCO,,5,9,9,SI,6,12,MUNICIPAL PROVINCIAL
624,11549,DEMOCRATA VERDE,1,53,LIMA - LIMA,2895,LIMA,LIMA,,5,27,26,SI,13,40,MUNICIPAL PROVINCIAL
625,3435,PODEMOS PERU,1,20,CUSCO - CUSCO,2731,CUSCO,CUSCO,,5,11,9,SI,6,14,MUNICIPAL PROVINCIAL
626,12017,AVANZA PAIS - PARTIDO DE INTEGRACION SOCIAL,1,21,CORONEL PORTILLO - UCAYALI,2173,UCAYALI,CORONEL PORTILLO,,5,11,10,SI,7,14,MUNICIPAL PROVINCIAL
627,26,PODEMOS PERU,1,17,CANCHIS - CUSCO,2731,CUSCO,CANCHIS,,5,9,8,SI,5,12,MUNICIPAL PROVINCIAL
628,12033,MOVIMIENTO DE INTEGRACION Y REVOLUCION ANDINA,1,7,MOHO - PUNO,2702,PUNO,MOHO,,5,4,3,SI,1,6,MUNICIPAL PROVINCIAL
629,3876,PODEMOS PERU,1,11,CAMANA - AREQUIPA,2731,AREQUIPA,CAMANA,,5,6,5,SI,1,10,MUNICIPAL PROVINCIAL
630,12045,JUNTOS POR EL DESARROLLO DE AREQUIPA,1,12,CAYLLOMA - AREQUIPA,2257,AREQUIPA,CAYLLOMA,,5,6,6,SI,2,10,MUNICIPAL PROVINCIAL
631,11079,FE EN EL PERU,1,10,UCAYALI - LORETO,2898,LORETO,UCAYALI,,5,5,5,NO,0,10,MUNICIPAL PROVINCIAL
632,12051,RENOVACION POPULAR,1,17,HUANCAYO - JUNIN,22,JUNIN,HUANCAYO,,5,9,8,SI,1,16,MUNICIPAL PROVINCIAL
633,10608,ACCION POPULAR,2,19,ICA - ICA,4,ICA,ICA,,5,10,9,SI,5,14,MUNICIPAL PROVINCIAL
634,9505,AVANZA PAIS - PARTIDO DE INTEGRACION SOCIAL,1,12,SANTIAGO DE CHUCO - LA LIBERTAD,2173,LA LIBERTAD,SANTIAGO DE CHUCO,,5,6,6,SI,2,10,MUNICIPAL PROVINCIAL
635,10085,PARTIDO DEMOCRATICO SOMOS PERU,1,14,OXAPAMPA - PASCO,14,PASCO,OXAPAMPA,,5,8,6,SI,4,10,MUNICIPAL PROVINCIAL
636,8154,ACCION POPULAR,1,10,ILO - MOQUEGUA,4,MOQUEGUA,ILO,,5,5,5,NO,0,10,MUNICIPAL PROVINCIAL
637,10553,ACCION POPULAR,1,14,PISCO - ICA,4,ICA,PISCO,,5,7,7,SI,2,12,MUNICIPAL PROVINCIAL
638,10604,ACCION POPULAR,1,14,ICA - ICA,4,ICA,ICA,,5,8,6,NO,0,14,MUNICIPAL PROVINCIAL
639,9946,PARTIDO DEMOCRATICO SOMOS PERU,1,13,HUAURA - LIMA,14,LIMA,HUAURA,,5,7,6,SI,1,12,MUNICIPAL PROVINCIAL
640,11097,FE EN EL PERU,1,16,MAYNAS - LORETO,2898,LORETO,MAYNAS,,5,9,7,NO,0,16,MUNICIPAL PROVINCIAL
641,12077,PARTIDO POLITICO NACIONAL PERU LIBRE,1,24,AREQUIPA - AREQUIPA,2218,AREQUIPA,AREQUIPA,,5,12,12,SI,8,16,MUNICIPAL PROVINCIAL
642,12113,MOVIMIENTO DE INTEGRACION Y REVOLUCION ANDINA,1,13,CARABAYA - PUNO,2702,PUNO,CARABAYA,,5,7,6,SI,3,10,MUNICIPAL PROVINCIAL
643,8849,SI SE PUEDE CALLAO,1,22,CALLAO - CALLAO,2902,CALLAO,CALLAO,,5,12,10,SI,6,16,MUNICIPAL PROVINCIAL
644,8125,ACCION POPULAR,1,14,FERREÑAFE - LAMBAYEQUE,4,LAMBAYEQUE,FERREÑAFE,,5,8,6,SI,2,12,MUNICIPAL PROVINCIAL
645,1211,MOVIMIENTO INDEPENDIENTE REIVINDIQUEMOS LORETO,1,16,ALTO AMAZONAS - LORETO,2874,LORETO,ALTO AMAZONAS,,5,9,7,SI,4,12,MUNICIPAL PROVINCIAL
646,631,PARTIDO FRENTE DE LA ESPERANZA 2021,1,17,ANDAHUAYLAS - APURIMAC,2857,APURIMAC,ANDAHUAYLAS,,5,9,8,SI,5,12,MUNICIPAL PROVINCIAL
647,10928,REGION PARA TODOS,1,16,HUANCABAMBA - PIURA,1411,PIURA,HUANCABAMBA,,5,9,7,SI,4,12,MUNICIPAL PROVINCIAL
648,12135,PARTIDO PATRIOTICO DEL PERU,1,10,HUAYLAS - ANCASH,2869,ANCASH,HUAYLAS,,5,5,5,NO,0,10,MUNICIPAL PROVINCIAL
649,5202,ACCION POPULAR,1,11,CAMANA - AREQUIPA,4,AREQUIPA,CAMANA,,5,5,6,NO,1,10,MUNICIPAL PROVINCIAL
650,12104,MOVIMIENTO REGIONAL EL MAICITO,1,17,SANTA - ANCASH,2245,ANCASH,SANTA,,5,8,9,SI,3,14,MUNICIPAL PROVINCIAL
651,11014,REGION PARA TODOS,1,18,SULLANA - PIURA,1411,PIURA,SULLANA,,5,9,9,SI,4,14,MUNICIPAL PROVINCIAL
652,5216,ACCION POPULAR,1,10,ISLAY - AREQUIPA,4,AREQUIPA,ISLAY,,5,5,5,NO,0,10,MUNICIPAL PROVINCIAL
653,997,PARTIDO POLITICO NACIONAL PERU LIBRE,1,22,CHICLAYO - LAMBAYEQUE,2218,LAMBAYEQUE,CHICLAYO,,5,11,11,SI,6,16,MUNICIPAL PROVINCIAL
654,12151,PARTIDO MORADO,1,46,LIMA - LIMA,2840,LIMA,LIMA,,5,23,23,SI,6,40,MUNICIPAL PROVINCIAL
655,5050,FE EN EL PERU,1,16,CALLAO - CALLAO,2898,CALLAO,CALLAO,,5,8,8,NO,0,16,MUNICIPAL PROVINCIAL
656,201,CAMINEMOS JUNTOS POR JUNIN,1,12,JAUJA - JUNIN,122,JUNIN,JAUJA,,5,6,6,SI,2,10,MUNICIPAL PROVINCIAL
657,12165,PARTIDO POLITICO NACIONAL PERU LIBRE,1,15,FERREÑAFE - LAMBAYEQUE,2218,LAMBAYEQUE,FERREÑAFE,,5,8,7,SI,3,12,MUNICIPAL PROVINCIAL
658,7369,FE EN EL PERU,1,15,HUAURA - LIMA,2898,LIMA,HUAURA,,5,8,7,SI,3,12,MUNICIPAL PROVINCIAL
659,7379,ACCION POPULAR,1,14,CAÑETE - LIMA,4,LIMA,CAÑETE,,5,7,7,SI,2,12,MUNICIPAL PROVINCIAL
660,8335,FE EN EL PERU,1,14,TACNA - TACNA,2898,TACNA,TACNA,,5,8,6,NO,0,14,MUNICIPAL PROVINCIAL
661,7127,FE EN EL PERU,1,12,HUARAZ - ANCASH,2898,ANCASH,HUARAZ,,5,7,5,NO,0,12,MUNICIPAL PROVINCIAL
662,7093,FE EN EL PERU,1,12,HUAMANGA - AYACUCHO,2898,AYACUCHO,HUAMANGA,,5,6,6,NO,0,12,MUNICIPAL PROVINCIAL
663,12254,PARTIDO POLITICO NACIONAL PERU LIBRE,1,8,ANTONIO RAIMONDI - ANCASH,2218,ANCASH,ANTONIO RAIMONDI,,5,4,4,SI,2,6,MUNICIPAL PROVINCIAL
664,11909,PARTIDO FRENTE DE LA ESPERANZA 2021,1,10,ANTABAMBA - APURIMAC,2857,APURIMAC,ANTABAMBA,,5,6,4,SI,4,6,MUNICIPAL PROVINCIAL
665,10729,PARTIDO FRENTE DE LA ESPERANZA 2021,1,22,TALARA - PIURA,2857,PIURA,TALARA,,5,10,12,SI,10,12,MUNICIPAL PROVINCIAL
666,10998,PARTIDO FRENTE DE LA ESPERANZA 2021,1,16,SULLANA - PIURA,2857,PIURA,SULLANA,,5,8,8,SI,2,14,MUNICIPAL PROVINCIAL
667,12286,PARTIDO POLITICO NACIONAL PERU LIBRE,1,28,SAN ROMAN - PUNO,2218,PUNO,SAN ROMAN,,5,15,13,SI,14,14,MUNICIPAL PROVINCIAL
668,12303,PARTIDO POLITICO NACIONAL PERU LIBRE,1,11,CARAVELI - AREQUIPA,2218,AREQUIPA,CARAVELI,,5,5,6,SI,3,8,MUNICIPAL PROVINCIAL
669,11364,MOVIMIENTO POLITICO REGIONAL DIGNIDAD TUMBESINA,1,6,CONTRALMIRANTE VILLAR - TUMBES,2754,TUMBES,CONTRALMIRANTE VILLAR,,5,3,3,NO,0,6,MUNICIPAL PROVINCIAL
670,12313,PARTIDO POLITICO NACIONAL PERU LIBRE,1,10,CASTILLA - AREQUIPA,2218,AREQUIPA,CASTILLA,,5,5,5,SI,2,8,MUNICIPAL PROVINCIAL
671,12363,PARTIDO POLITICO NACIONAL PERU LIBRE,1,12,DANIEL ALCIDES CARRION - PASCO,2218,PASCO,DANIEL ALCIDES CARRION,,5,6,6,SI,4,8,MUNICIPAL PROVINCIAL
672,12352,FRENTE REGIONAL DE CAJAMARCA,1,16,JAEN - CAJAMARCA,160,CAJAMARCA,JAEN,,5,8,8,SI,4,12,MUNICIPAL PROVINCIAL
673,12377,JUNTOS POR TACNA,1,20,TACNA - TACNA,2868,TACNA,TACNA,,5,11,9,SI,6,14,MUNICIPAL PROVINCIAL
674,1115,RENOVACION POPULAR,1,15,FERREÑAFE - LAMBAYEQUE,22,LAMBAYEQUE,FERREÑAFE,,5,8,7,SI,3,12,MUNICIPAL PROVINCIAL
675,11712,ACCION POPULAR,1,13,CHEPEN - LA LIBERTAD,4,LA LIBERTAD,CHEPEN,,5,7,6,SI,3,10,MUNICIPAL PROVINCIAL
676,12412,PARTIDO POLITICO NACIONAL PERU LIBRE,1,17,UCAYALI - LORETO,2218,LORETO,UCAYALI,,5,9,8,SI,7,10,MUNICIPAL PROVINCIAL
677,12394,UNION REGIONAL,1,14,LAMAS - SAN MARTIN,2722,SAN MARTIN,LAMAS,,5,8,6,SI,4,10,MUNICIPAL PROVINCIAL
678,12416,RENOVACION POPULAR,1,17,CAÑETE - LIMA,22,LIMA,CAÑETE,,5,9,8,SI,5,12,MUNICIPAL PROVINCIAL
679,12345,PARTIDO DEMOCRATICO SOMOS PERU,1,21,MOYOBAMBA - SAN MARTIN,14,SAN MARTIN,MOYOBAMBA,,5,11,10,SI,9,12,MUNICIPAL PROVINCIAL
680,12425,PARTIDO MORADO,1,10,AMBO - HUANUCO,2840,HUANUCO,AMBO,,5,5,5,NO,0,10,MUNICIPAL PROVINCIAL
681,1118,RENOVACION POPULAR,1,17,LAMBAYEQUE - LAMBAYEQUE,22,LAMBAYEQUE,LAMBAYEQUE,,5,8,9,SI,3,14,MUNICIPAL PROVINCIAL
682,12457,PARTIDO MORADO,1,10,HUAMALIES - HUANUCO,2840,HUANUCO,HUAMALIES,,5,4,6,NO,0,10,MUNICIPAL PROVINCIAL
683,12443,FRENTE POPULAR AGRICOLA FIA DEL PERU,1,14,JAEN - CAJAMARCA,2901,CAJAMARCA,JAEN,,5,7,7,SI,2,12,MUNICIPAL PROVINCIAL
684,10379,AREQUIPA TRANSFORMACION,1,13,ISLAY - AREQUIPA,2313,AREQUIPA,ISLAY,,5,7,6,SI,3,10,MUNICIPAL PROVINCIAL
685,11531,ACCION POPULAR,1,20,TRUJILLO - LA LIBERTAD,4,LA LIBERTAD,TRUJILLO,,5,11,9,SI,4,16,MUNICIPAL PROVINCIAL
686,8967,PARTIDO POLITICO NACIONAL PERU LIBRE,1,20,PIURA - PIURA,2218,PIURA,PIURA,,5,11,9,SI,4,16,MUNICIPAL PROVINCIAL
687,4903,FRENTE REGIONAL DE CAJAMARCA,1,20,CAJAMARCA - CAJAMARCA,160,CAJAMARCA,CAJAMARCA,,5,10,10,SI,6,14,MUNICIPAL PROVINCIAL
688,12427,UNION REGIONAL,1,22,RIOJA - SAN MARTIN,2722,SAN MARTIN,RIOJA,,5,11,11,SI,10,12,MUNICIPAL PROVINCIAL
689,12451,PARTIDO POLITICO NACIONAL PERU LIBRE,1,12,HUANCABAMBA - PIURA,2218,PIURA,HUANCABAMBA,,5,7,5,NO,0,12,MUNICIPAL PROVINCIAL
690,12508,PARTIDO MORADO,1,14,LEONCIO PRADO - HUANUCO,2840,HUANUCO,LEONCIO PRADO,,5,8,6,SI,2,12,MUNICIPAL PROVINCIAL
691,12486,PARTIDO POLITICO NACIONAL PERU LIBRE,1,9,CARLOS FERMIN FITZCARRALD - ANCASH,2218,ANCASH,CARLOS FERMIN FITZCARRALD,,5,5,4,SI,3,6,MUNICIPAL PROVINCIAL
692,4816,PODEMOS PERU,1,23,TAMBOPATA - MADRE DE DIOS,2731,MADRE DE DIOS,TAMBOPATA,,5,12,11,SI,11,12,MUNICIPAL PROVINCIAL
693,11607,YO AREQUIPA,1,15,CASTILLA - AREQUIPA,2744,AREQUIPA,CASTILLA,,5,8,7,SI,7,8,MUNICIPAL PROVINCIAL
694,9018,PARTIDO PATRIOTICO DEL PERU,1,16,PIURA - PIURA,2869,PIURA,PIURA,,5,9,7,NO,0,16,MUNICIPAL PROVINCIAL
695,12493,ALIANZA POR NUESTRO DESARROLLO,1,12,LUCANAS - AYACUCHO,2710,AYACUCHO,LUCANAS,,5,7,5,SI,2,10,MUNICIPAL PROVINCIAL
696,8544,CONTIGO REGION,1,18,TALARA - PIURA,2862,PIURA,TALARA,,5,10,8,SI,6,12,MUNICIPAL PROVINCIAL
697,12559,PODEMOS PERU,1,12,AZANGARO - PUNO,2731,PUNO,AZANGARO,,5,6,6,NO,0,12,MUNICIPAL PROVINCIAL
698,12512,PARTIDO POLITICO NACIONAL PERU LIBRE,1,24,TALARA - PIURA,2218,PIURA,TALARA,,5,12,12,SI,12,12,MUNICIPAL PROVINCIAL
699,5048,PODEMOS PERU,1,18,SAN ROMAN - PUNO,2731,PUNO,SAN ROMAN,,5,9,9,SI,4,14,MUNICIPAL PROVINCIAL
700,9283,PARTIDO POLITICO NACIONAL PERU LIBRE,1,12,AYABACA - PIURA,2218,PIURA,AYABACA,,5,7,5,NO,0,12,MUNICIPAL PROVINCIAL
701,7161,AVANZA PAIS - PARTIDO DE INTEGRACION SOCIAL,1,11,MARISCAL NIETO - MOQUEGUA,2173,MOQUEGUA,MARISCAL NIETO,,5,6,5,SI,1,10,MUNICIPAL PROVINCIAL
702,10530,PODEMOS PERU,1,20,AREQUIPA - AREQUIPA,2731,AREQUIPA,AREQUIPA,,5,10,10,SI,4,16,MUNICIPAL PROVINCIAL
703,12583,FRENTE POPULAR AGRICOLA FIA DEL PERU,1,6,ACOMAYO - CUSCO,2901,CUSCO,ACOMAYO,,5,3,3,NO,0,6,MUNICIPAL PROVINCIAL
704,12433,MOVIMIENTO INDEPENDIENTE FUERZA REGIONAL,1,19,PIURA - PIURA,1388,PIURA,PIURA,,5,10,9,SI,3,16,MUNICIPAL PROVINCIAL
705,2119,ACCION POPULAR,1,14,CORONEL PORTILLO - UCAYALI,4,UCAYALI,CORONEL PORTILLO,,5,7,7,NO,0,14,MUNICIPAL PROVINCIAL
706,2193,ACCION POPULAR,1,10,ATALAYA - UCAYALI,4,UCAYALI,ATALAYA,,5,5,5,NO,0,10,MUNICIPAL PROVINCIAL
707,3611,PODEMOS PERU,1,16,SULLANA - PIURA,2731,PIURA,SULLANA,,5,8,8,SI,2,14,MUNICIPAL PROVINCIAL
708,8451,JUNIN RENACE,1,13,CHUPACA - JUNIN,2716,JUNIN,CHUPACA,,5,7,6,SI,3,10,MUNICIPAL PROVINCIAL
709,7921,REFORMA Y HONRADEZ POR MAS OBRAS,1,13,LAMPA - PUNO,2912,PUNO,LAMPA,,5,7,6,SI,5,8,MUNICIPAL PROVINCIAL
710,2219,ACCION POPULAR,1,10,PADRE ABAD - UCAYALI,4,UCAYALI,PADRE ABAD,,5,6,4,NO,0,10,MUNICIPAL PROVINCIAL
711,12598,PARTIDO POLITICO NACIONAL PERU LIBRE,1,12,LA MAR - AYACUCHO,2218,AYACUCHO,LA MAR,,5,7,5,SI,2,10,MUNICIPAL PROVINCIAL
712,12614,MOVIMIENTO ACCION NACIONALISTA PERUANO,1,8,SIHUAS - ANCASH,360,ANCASH,SIHUAS,,5,5,3,NO,0,8,MUNICIPAL PROVINCIAL
713,12218,PARTIDO POLITICO NACIONAL PERU LIBRE,1,10,POMABAMBA - ANCASH,2218,ANCASH,POMABAMBA,,5,6,4,SI,2,8,MUNICIPAL PROVINCIAL
714,2258,ACCION POPULAR,1,7,PURUS - UCAYALI,4,UCAYALI,PURUS,,5,4,3,SI,1,6,MUNICIPAL PROVINCIAL
715,3630,MOVIMIENTO REGIONAL FORTALEZA PERU,1,13,SANTIAGO DE CHUCO - LA LIBERTAD,2738,LA LIBERTAD,SANTIAGO DE CHUCO,,5,7,6,SI,3,10,MUNICIPAL PROVINCIAL
716,1235,PODEMOS PERU,1,27,PIURA - PIURA,2731,PIURA,PIURA,,5,14,13,SI,11,16,MUNICIPAL PROVINCIAL
717,3647,FUERZA CHALACA,1,16,CALLAO - CALLAO,2676,CALLAO,CALLAO,,5,9,7,NO,0,16,MUNICIPAL PROVINCIAL
718,12374,ORGANIZACION POLITICA UNIDAD REGIONAL,1,16,AYABACA - PIURA,2711,PIURA,AYABACA,,5,8,8,SI,4,12,MUNICIPAL PROVINCIAL
719,12658,AVANZA PAIS - PARTIDO DE INTEGRACION SOCIAL,1,10,ILO - MOQUEGUA,2173,MOQUEGUA,ILO,,5,5,5,NO,0,10,MUNICIPAL PROVINCIAL
720,331,PODEMOS PERU,1,7,GENERAL SANCHEZ CERRO - MOQUEGUA,2731,MOQUEGUA,GENERAL SANCHEZ CERRO,,5,4,3,SI,1,6,MUNICIPAL PROVINCIAL
721,11057,FE EN EL PERU,1,10,LORETO - LORETO,2898,LORETO,LORETO,,5,5,5,NO,0,10,MUNICIPAL PROVINCIAL
722,12686,JUNIN RENACE,1,11,CONCEPCION - JUNIN,2716,JUNIN,CONCEPCION,,5,6,5,SI,1,10,MUNICIPAL PROVINCIAL
723,12418,MOVIMIENTO INDEPENDIENTE FUERZA REGIONAL,1,17,SULLANA - PIURA,1388,PIURA,SULLANA,,5,9,8,SI,3,14,MUNICIPAL PROVINCIAL
724,12062,SUMATE,1,21,TRUJILLO - LA LIBERTAD,67,LA LIBERTAD,TRUJILLO,,5,11,10,SI,5,16,MUNICIPAL PROVINCIAL
725,3207,MOVIMIENTO REGIONAL EL MAICITO,1,12,SIHUAS - ANCASH,2245,ANCASH,SIHUAS,,5,6,6,SI,4,8,MUNICIPAL PROVINCIAL
726,9415,MOVIMIENTO INDEPENDIENTE REIVINDIQUEMOS LORETO,1,12,DATEM DEL MARAÑON - LORETO,2874,LORETO,DATEM DEL MARAÑON,,5,7,5,SI,2,10,MUNICIPAL PROVINCIAL
727,12450,RENOVACION POPULAR,1,14,BAGUA - AMAZONAS,22,AMAZONAS,BAGUA,,5,8,6,SI,4,10,MUNICIPAL PROVINCIAL
728,10102,GESTIONANDO OBRAS Y OPORTUNIDADES CON LIDERAZGO,2,11,SAN ANTONIO DE PUTINA - PUNO,2667,PUNO,SAN ANTONIO DE PUTINA,,5,6,5,SI,3,8,MUNICIPAL PROVINCIAL
729,12720,PIURA RENACE,1,12,SECHURA - PIURA,2876,PIURA,SECHURA,,5,6,6,SI,2,10,MUNICIPAL PROVINCIAL
730,11146,MOVIMIENTO REGIONAL FORTALEZA PERU,1,8,JULCAN - LA LIBERTAD,2738,LA LIBERTAD,JULCAN,,5,5,3,NO,0,8,MUNICIPAL PROVINCIAL
731,10562,ACCION POPULAR,2,12,PISCO - ICA,4,ICA,PISCO,,5,6,6,NO,0,12,MUNICIPAL PROVINCIAL
732,12196,MOVIMIENTO VERDE UNIDO,1,22,CHICLAYO - LAMBAYEQUE,2343,LAMBAYEQUE,CHICLAYO,,5,12,10,SI,6,16,MUNICIPAL PROVINCIAL
733,11678,REFORMA Y HONRADEZ POR MAS OBRAS,1,20,HUANCANE - PUNO,2912,PUNO,HUANCANE,,5,11,9,SI,10,10,MUNICIPAL PROVINCIAL
734,12741,PARTIDO DEMOCRATICO SOMOS PERU,1,7,CARLOS FERMIN FITZCARRALD - ANCASH,14,ANCASH,CARLOS FERMIN FITZCARRALD,,5,4,3,SI,1,6,MUNICIPAL PROVINCIAL
735,12725,MOVIMIENTO DE INTEGRACION Y REVOLUCION ANDINA,1,13,SAN ANTONIO DE PUTINA - PUNO,2702,PUNO,SAN ANTONIO DE PUTINA,,5,7,6,SI,5,8,MUNICIPAL PROVINCIAL
736,34,PODEMOS PERU,1,12,CHUMBIVILCAS - CUSCO,2731,CUSCO,CHUMBIVILCAS,,5,7,5,SI,2,10,MUNICIPAL PROVINCIAL
737,3242,MOVIMIENTO REGIONAL EL MAICITO,1,10,ASUNCION - ANCASH,2245,ANCASH,ASUNCION,,5,5,5,SI,4,6,MUNICIPAL PROVINCIAL
738,12759,PATRIA JOVEN,1,14,BARRANCA - LIMA,553,LIMA,BARRANCA,,5,8,6,SI,2,12,MUNICIPAL PROVINCIAL
739,12650,PROGRESISTA DE APURIMAC,1,6,ANTABAMBA - APURIMAC,2737,APURIMAC,ANTABAMBA,,5,4,2,NO,0,6,MUNICIPAL PROVINCIAL
740,12466,PARTIDO POLITICO NACIONAL PERU LIBRE,1,10,DATEM DEL MARAÑON - LORETO,2218,LORETO,DATEM DEL MARAÑON,,5,6,4,NO,0,10,MUNICIPAL PROVINCIAL
741,11172,AVANZA PAIS - PARTIDO DE INTEGRACION SOCIAL,1,16,AREQUIPA - AREQUIPA,2173,AREQUIPA,AREQUIPA,,5,9,7,NO,0,16,MUNICIPAL PROVINCIAL
742,3865,PARTIDO DEMOCRATICO SOMOS PERU,1,10,CONTUMAZA - CAJAMARCA,14,CAJAMARCA,CONTUMAZA,,5,6,4,SI,2,8,MUNICIPAL PROVINCIAL
743,12784,MOVIMIENTO ACCION NACIONALISTA PERUANO,1,14,HUARAZ - ANCASH,360,ANCASH,HUARAZ,,5,8,6,SI,2,12,MUNICIPAL PROVINCIAL
744,12815,PARTIDO DEMOCRATICO SOMOS PERU,1,15,URUBAMBA - CUSCO,14,CUSCO,URUBAMBA,,5,8,7,SI,5,10,MUNICIPAL PROVINCIAL
745,12822,SUMATE,1,12,VIRU - LA LIBERTAD,67,LA LIBERTAD,VIRU,,5,7,5,SI,2,10,MUNICIPAL PROVINCIAL
746,1906,MOVIMIENTO INDEPENDIENTE REGIONAL HUANUCO PRIMERO,1,12,DOS DE MAYO - HUANUCO,2162,HUANUCO,DOS DE MAYO,,5,7,5,SI,4,8,MUNICIPAL PROVINCIAL
747,12841,SENTIMIENTO AMAZONENSE REGIONAL,1,10,CONDORCANQUI - AMAZONAS,2277,AMAZONAS,CONDORCANQUI,,5,6,4,SI,2,8,MUNICIPAL PROVINCIAL
748,12663,MOVIMIENTO ACCION REGIONAL,1,12,MELGAR - PUNO,2866,PUNO,MELGAR,,5,6,6,SI,2,10,MUNICIPAL PROVINCIAL
749,12853,PARTIDO DEMOCRATICO SOMOS PERU,1,13,REQUENA - LORETO,14,LORETO,REQUENA,,5,7,6,SI,3,10,MUNICIPAL PROVINCIAL
750,7704,"AREQUIPA, TRADICION Y FUTURO",1,12,ISLAY - AREQUIPA,142,AREQUIPA,ISLAY,,5,6,6,SI,2,10,MUNICIPAL PROVINCIAL
751,12843,FUERZA LORETANA,1,21,MAYNAS - LORETO,61,LORETO,MAYNAS,,5,11,10,SI,5,16,MUNICIPAL PROVINCIAL
752,7605,PARTIDO PATRIOTICO DEL PERU,1,15,SANTA - ANCASH,2869,ANCASH,SANTA,,5,8,7,SI,1,14,MUNICIPAL PROVINCIAL
753,3269,MOVIMIENTO REGIONAL EL MAICITO,1,11,CARLOS FERMIN FITZCARRALD - ANCASH,2245,ANCASH,CARLOS FERMIN FITZCARRALD,,5,6,5,SI,5,6,MUNICIPAL PROVINCIAL
754,5073,MOVIMIENTO REGIONAL EL MAICITO,1,10,POMABAMBA - ANCASH,2245,ANCASH,POMABAMBA,,5,6,4,SI,2,8,MUNICIPAL PROVINCIAL
755,7484,ALIANZA GOBIERNO UNIDAD Y ACCION,1,20,HUARAZ - ANCASH,2856,ANCASH,HUARAZ,,5,10,10,SI,8,12,MUNICIPAL PROVINCIAL
756,3289,MOVIMIENTO REGIONAL EL MAICITO,1,11,AIJA - ANCASH,2245,ANCASH,AIJA,,5,6,5,SI,5,6,MUNICIPAL PROVINCIAL
757,4273,MOVIMIENTO REGIONAL EL MAICITO,1,8,CORONGO - ANCASH,2245,ANCASH,CORONGO,,5,4,4,SI,2,6,MUNICIPAL PROVINCIAL
758,2889,MOVIMIENTO INDEPENDIENTE REIVINDIQUEMOS LORETO,1,13,UCAYALI - LORETO,2874,LORETO,UCAYALI,,5,7,6,SI,3,10,MUNICIPAL PROVINCIAL
759,3283,MOVIMIENTO REGIONAL EL MAICITO,1,6,OCROS - ANCASH,2245,ANCASH,OCROS,,5,3,3,NO,0,6,MUNICIPAL PROVINCIAL
760,2516,MOVIMIENTO INDEPENDIENTE REIVINDIQUEMOS LORETO,1,12,MARISCAL RAMON CASTILLA - LORETO,2874,LORETO,MARISCAL RAMON CASTILLA,,5,6,6,SI,2,10,MUNICIPAL PROVINCIAL
761,5932,MOVIMIENTO CIVICO PERUANO,1,8,CANDARAVE - TACNA,2351,TACNA,CANDARAVE,,5,4,4,SI,2,6,MUNICIPAL PROVINCIAL
762,2034,MOVIMIENTO INDEPENDIENTE REIVINDIQUEMOS LORETO,1,12,LORETO - LORETO,2874,LORETO,LORETO,,5,7,5,SI,2,10,MUNICIPAL PROVINCIAL
763,3408,MOVIMIENTO REGIONAL FORTALEZA PERU,1,22,SANCHEZ CARRION - LA LIBERTAD,2738,LA LIBERTAD,SANCHEZ CARRION,,5,12,10,SI,10,12,MUNICIPAL PROVINCIAL
764,5881,MOVIMIENTO REGIONAL EL MAICITO,1,11,YUNGAY - ANCASH,2245,ANCASH,YUNGAY,,5,6,5,SI,1,10,MUNICIPAL PROVINCIAL
765,12620,PARTIDO POLITICO NACIONAL PERU LIBRE,2,19,TALARA - PIURA,2218,PIURA,TALARA,,5,10,9,SI,7,12,MUNICIPAL PROVINCIAL
766,6909,MOVIMIENTO REGIONAL FORTALEZA PERU,1,20,PACASMAYO - LA LIBERTAD,2738,LA LIBERTAD,PACASMAYO,,5,10,10,SI,8,12,MUNICIPAL PROVINCIAL
767,4719,PARTIDO POLITICO NACIONAL PERU LIBRE,1,17,HUAURA - LIMA,2218,LIMA,HUAURA,,5,9,8,SI,5,12,MUNICIPAL PROVINCIAL
768,1208,RENOVACION POPULAR,1,53,LIMA - LIMA,22,LIMA,LIMA,,5,27,26,SI,13,40,MUNICIPAL PROVINCIAL
769,8245,AVANZA PAIS - PARTIDO DE INTEGRACION SOCIAL,1,13,JAUJA - JUNIN,2173,JUNIN,JAUJA,,5,7,6,SI,3,10,MUNICIPAL PROVINCIAL
770,12235,PARTIDO MORADO,1,10,CASMA - ANCASH,2840,ANCASH,CASMA,,5,6,4,NO,0,10,MUNICIPAL PROVINCIAL
771,12081,RENOVACION POPULAR,1,13,SATIPO - JUNIN,22,JUNIN,SATIPO,,5,6,7,SI,1,12,MUNICIPAL PROVINCIAL
772,912,CAJAMARCA SIEMPRE VERDE,1,10,SANTA CRUZ - CAJAMARCA,1464,CAJAMARCA,SANTA CRUZ,,5,5,5,SI,2,8,MUNICIPAL PROVINCIAL
773,12564,ALIANZA PARA EL PROGRESO,1,19,ICA - ICA,1257,ICA,ICA,,5,10,9,SI,5,14,MUNICIPAL PROVINCIAL
774,12560,ALIANZA PARA EL PROGRESO,1,10,PALPA - ICA,1257,ICA,PALPA,,5,5,5,SI,4,6,MUNICIPAL PROVINCIAL
775,3255,MOVIMIENTO REGIONAL EL MAICITO,1,6,ANTONIO RAIMONDI - ANCASH,2245,ANCASH,ANTONIO RAIMONDI,,5,4,2,NO,0,6,MUNICIPAL PROVINCIAL
776,11529,ALIANZA PARA EL PROGRESO,1,16,NASCA - ICA,1257,ICA,NASCA,,5,8,8,SI,6,10,MUNICIPAL PROVINCIAL
777,12709,FRENTE POPULAR AGRICOLA FIA DEL PERU,1,12,UTCUBAMBA - AMAZONAS,2901,AMAZONAS,UTCUBAMBA,,5,6,6,NO,0,12,MUNICIPAL PROVINCIAL
778,11519,ALIANZA PARA EL PROGRESO,2,16,CHINCHA - ICA,1257,ICA,CHINCHA,,5,9,7,SI,4,12,MUNICIPAL PROVINCIAL
779,11669,MOVIMIENTO REGIONAL BLOQUE POPULAR JUNIN,1,10,YAULI - JUNIN,2169,JUNIN,YAULI,,5,6,4,SI,2,8,MUNICIPAL PROVINCIAL
780,11492,ALIANZA PARA EL PROGRESO,1,16,PISCO - ICA,1257,ICA,PISCO,,5,9,7,SI,4,12,MUNICIPAL PROVINCIAL
781,3578,MOVIMIENTO REGIONAL BLOQUE POPULAR JUNIN,1,17,CONCEPCION - JUNIN,2169,JUNIN,CONCEPCION,,5,9,8,SI,7,10,MUNICIPAL PROVINCIAL
782,12990,MOVIMIENTO ACCION NACIONALISTA PERUANO,1,10,HUARI - ANCASH,360,ANCASH,HUARI,,5,5,5,NO,0,10,MUNICIPAL PROVINCIAL
783,11470,ALIANZA PARA EL PROGRESO,1,19,CHINCHA - ICA,1257,ICA,CHINCHA,,5,10,9,SI,7,12,MUNICIPAL PROVINCIAL
784,721,PARTIDO FRENTE DE LA ESPERANZA 2021,1,14,TUMBES - TUMBES,2857,TUMBES,TUMBES,,5,7,7,SI,2,12,MUNICIPAL PROVINCIAL
785,8329,YO AREQUIPA,1,31,AREQUIPA - AREQUIPA,2744,AREQUIPA,AREQUIPA,,5,16,15,SI,15,16,MUNICIPAL PROVINCIAL
786,13034,SUMATE,1,14,PACASMAYO - LA LIBERTAD,67,LA LIBERTAD,PACASMAYO,,5,8,6,SI,2,12,MUNICIPAL PROVINCIAL
787,12974,PARTIDO DEMOCRATICO SOMOS PERU,1,19,CALLAO - CALLAO,14,CALLAO,CALLAO,,5,10,9,SI,3,16,MUNICIPAL PROVINCIAL
788,13012,NUEVA LIBERTAD,1,12,SANCHEZ CARRION - LA LIBERTAD,2232,LA LIBERTAD,SANCHEZ CARRION,,5,7,5,NO,0,12,MUNICIPAL PROVINCIAL
789,390,PODEMOS PERU,1,17,JAEN - CAJAMARCA,2731,CAJAMARCA,JAEN,,5,9,8,SI,5,12,MUNICIPAL PROVINCIAL
790,7243,CAJAMARCA SIEMPRE VERDE,1,16,JAEN - CAJAMARCA,1464,CAJAMARCA,JAEN,,5,9,7,SI,4,12,MUNICIPAL PROVINCIAL
791,3431,"AREQUIPA, TRADICION Y FUTURO",1,19,AREQUIPA - AREQUIPA,142,AREQUIPA,AREQUIPA,,5,10,9,SI,3,16,MUNICIPAL PROVINCIAL
792,13061,SOCIOS POR ANCASH,1,17,HUARI - ANCASH,2881,ANCASH,HUARI,,5,9,8,SI,7,10,MUNICIPAL PROVINCIAL
793,12885,PARTIDO DEMOCRATICO SOMOS PERU,1,10,CANAS - CUSCO,14,CUSCO,CANAS,,5,6,4,SI,2,8,MUNICIPAL PROVINCIAL
794,5643,FE EN EL PERU,1,12,HUAROCHIRI - LIMA,2898,LIMA,HUAROCHIRI,,5,6,6,SI,2,10,MUNICIPAL PROVINCIAL
795,5272,ACCION POPULAR,1,16,AREQUIPA - AREQUIPA,4,AREQUIPA,AREQUIPA,,5,8,8,NO,0,16,MUNICIPAL PROVINCIAL
796,12964,JUNTOS POR EL PERU,1,22,TRUJILLO - LA LIBERTAD,1264,LA LIBERTAD,TRUJILLO,,5,12,10,SI,6,16,MUNICIPAL PROVINCIAL
797,12913,PARTIDO DEMOCRATICO SOMOS PERU,1,10,YUNGAY - ANCASH,14,ANCASH,YUNGAY,,5,6,4,NO,0,10,MUNICIPAL PROVINCIAL
798,10038,PARTIDO FRENTE DE LA ESPERANZA 2021,1,14,CUTERVO - CAJAMARCA,2857,CAJAMARCA,CUTERVO,,5,8,6,SI,2,12,MUNICIPAL PROVINCIAL
799,10026,PARTIDO FRENTE DE LA ESPERANZA 2021,1,6,SAN PABLO - CAJAMARCA,2857,CAJAMARCA,SAN PABLO,,5,4,2,NO,0,6,MUNICIPAL PROVINCIAL
800,10535,PARTIDO POLITICO NACIONAL PERU LIBRE,1,15,HUAMANGA - AYACUCHO,2218,AYACUCHO,HUAMANGA,,5,8,7,SI,3,12,MUNICIPAL PROVINCIAL
801,9988,PARTIDO FRENTE DE LA ESPERANZA 2021,1,10,SAN MIGUEL - CAJAMARCA,2857,CAJAMARCA,SAN MIGUEL,,5,6,4,SI,2,8,MUNICIPAL PROVINCIAL
802,9965,PARTIDO FRENTE DE LA ESPERANZA 2021,1,12,CELENDIN - CAJAMARCA,2857,CAJAMARCA,CELENDIN,,5,5,7,SI,2,10,MUNICIPAL PROVINCIAL
803,3747,PARTIDO FRENTE DE LA ESPERANZA 2021,1,16,JAEN - CAJAMARCA,2857,CAJAMARCA,JAEN,,5,9,7,SI,4,12,MUNICIPAL PROVINCIAL
804,11200,AVANZA PAIS - PARTIDO DE INTEGRACION SOCIAL,1,10,CAYLLOMA - AREQUIPA,2173,AREQUIPA,CAYLLOMA,,5,6,4,NO,0,10,MUNICIPAL PROVINCIAL
805,3337,PARTIDO FRENTE DE LA ESPERANZA 2021,1,10,SAN MARCOS - CAJAMARCA,2857,CAJAMARCA,SAN MARCOS,,5,6,4,NO,0,10,MUNICIPAL PROVINCIAL
806,2630,PARTIDO FRENTE DE LA ESPERANZA 2021,1,17,CAJAMARCA - CAJAMARCA,2857,CAJAMARCA,CAJAMARCA,,5,9,8,SI,3,14,MUNICIPAL PROVINCIAL
807,2472,PARTIDO FRENTE DE LA ESPERANZA 2021,1,16,SAN IGNACIO - CAJAMARCA,2857,CAJAMARCA,SAN IGNACIO,,5,9,7,SI,4,12,MUNICIPAL PROVINCIAL
808,12470,JUNTOS POR LORETO,1,10,LORETO - LORETO,2871,LORETO,LORETO,,5,6,4,NO,0,10,MUNICIPAL PROVINCIAL
809,13116,MOVIMIENTO INDEPENDIENTE REGIONAL MI BUEN VECINO,1,10,HUAMALIES - HUANUCO,2730,HUANUCO,HUAMALIES,,5,6,4,NO,0,10,MUNICIPAL PROVINCIAL
810,316,PODEMOS PERU,1,10,MARISCAL NIETO - MOQUEGUA,2731,MOQUEGUA,MARISCAL NIETO,,5,6,4,NO,0,10,MUNICIPAL PROVINCIAL
811,1414,MOVIMIENTO INDEPENDIENTE REIVINDIQUEMOS LORETO,1,13,REQUENA - LORETO,2874,LORETO,REQUENA,,5,7,6,SI,3,10,MUNICIPAL PROVINCIAL
812,13166,REGION PARA TODOS,1,14,MORROPON - PIURA,1411,PIURA,MORROPON,,5,7,7,SI,2,12,MUNICIPAL PROVINCIAL
813,13160,PIURA RENACE,1,15,PAITA - PIURA,2876,PIURA,PAITA,,5,8,7,SI,3,12,MUNICIPAL PROVINCIAL
814,12500,JUNTOS POR LORETO,1,18,MAYNAS - LORETO,2871,LORETO,MAYNAS,,5,9,9,SI,2,16,MUNICIPAL PROVINCIAL
815,740,PARTIDO FRENTE DE LA ESPERANZA 2021,1,11,ACOMAYO - CUSCO,2857,CUSCO,ACOMAYO,,5,6,5,SI,5,6,MUNICIPAL PROVINCIAL
816,3868,PARTIDO FRENTE DE LA ESPERANZA 2021,1,14,LA CONVENCION - CUSCO,2857,CUSCO,LA CONVENCION,,5,8,6,SI,2,12,MUNICIPAL PROVINCIAL
817,5203,AVANZADA REGIONAL INDEPENDIENTE UNIDOS POR HUANUCO,1,20,PUERTO INCA - HUANUCO,2201,HUANUCO,PUERTO INCA,,5,11,9,SI,12,8,MUNICIPAL PROVINCIAL
818,9235,ALIANZA GOBIERNO UNIDAD Y ACCION,1,9,RECUAY - ANCASH,2856,ANCASH,RECUAY,,5,5,4,SI,3,6,MUNICIPAL PROVINCIAL
819,1647,MOVIMIENTO POLITICO CAMBIEMOS X HCO,1,10,DOS DE MAYO - HUANUCO,2733,HUANUCO,DOS DE MAYO,,5,5,5,SI,2,8,MUNICIPAL PROVINCIAL
820,13246,PARTIDO POLITICO NACIONAL PERU LIBRE,1,10,CHEPEN - LA LIBERTAD,2218,LA LIBERTAD,CHEPEN,,5,5,5,NO,0,10,MUNICIPAL PROVINCIAL
821,10744,MOVIMIENTO REGIONAL BICENTENARIO,1,10,PATAZ - LA LIBERTAD,2906,LA LIBERTAD,PATAZ,,5,5,5,NO,0,10,MUNICIPAL PROVINCIAL
822,13264,TODOS SOMOS UCAYALI,1,8,PURUS - UCAYALI,1396,UCAYALI,PURUS,,5,5,3,SI,2,6,MUNICIPAL PROVINCIAL
823,4567,RENOVACION POPULAR,1,14,LA CONVENCION - CUSCO,22,CUSCO,LA CONVENCION,,5,8,6,SI,2,12,MUNICIPAL PROVINCIAL
824,13249,PODEMOS PERU,1,11,CALCA - CUSCO,2731,CUSCO,CALCA,,5,6,5,SI,1,10,MUNICIPAL PROVINCIAL
825,13304,AVANZA PAIS - PARTIDO DE INTEGRACION SOCIAL,1,14,HUARAL - LIMA,2173,LIMA,HUARAL,,5,8,6,SI,2,12,MUNICIPAL PROVINCIAL
826,13290,MOVIMIENTO REGIONAL BICENTENARIO,1,12,VIRU - LA LIBERTAD,2906,LA LIBERTAD,VIRU,,5,7,5,SI,2,10,MUNICIPAL PROVINCIAL
827,12315,ACCION POPULAR,1,16,MAYNAS - LORETO,4,LORETO,MAYNAS,,5,9,7,NO,0,16,MUNICIPAL PROVINCIAL
828,13256,JUNTOS POR LORETO,1,16,ALTO AMAZONAS - LORETO,2871,LORETO,ALTO AMAZONAS,,5,9,7,SI,4,12,MUNICIPAL PROVINCIAL
829,2992,CAJAMARCA SIEMPRE VERDE,1,13,SAN IGNACIO - CAJAMARCA,1464,CAJAMARCA,SAN IGNACIO,,5,7,6,SI,1,12,MUNICIPAL PROVINCIAL
830,3533,MOVIMIENTO POLITICO CAMBIEMOS X HCO,1,12,HUAMALIES - HUANUCO,2733,HUANUCO,HUAMALIES,,5,7,5,SI,2,10,MUNICIPAL PROVINCIAL
831,12848,PARTIDO DEMOCRATICO SOMOS PERU,1,18,OTUZCO - LA LIBERTAD,14,LA LIBERTAD,OTUZCO,,5,10,8,SI,8,10,MUNICIPAL PROVINCIAL
832,10187,PARTIDO POLITICO NACIONAL PERU LIBRE,1,16,YUNGUYO - PUNO,2218,PUNO,YUNGUYO,,5,9,7,SI,8,8,MUNICIPAL PROVINCIAL
833,13342,PARTIDO PATRIOTICO DEL PERU,1,12,CAÑETE - LIMA,2869,LIMA,CAÑETE,,5,6,6,NO,0,12,MUNICIPAL PROVINCIAL
834,13334,CONTIGO REGION,1,16,PAITA - PIURA,2862,PIURA,PAITA,,5,9,7,SI,4,12,MUNICIPAL PROVINCIAL
835,12318,ACCION POPULAR,2,16,MAYNAS - LORETO,4,LORETO,MAYNAS,,5,9,7,NO,0,16,MUNICIPAL PROVINCIAL
836,1296,PARTIDO FRENTE DE LA ESPERANZA 2021,1,14,CHOTA - CAJAMARCA,2857,CAJAMARCA,CHOTA,,5,8,6,SI,2,12,MUNICIPAL PROVINCIAL
837,5804,CONCERTACION PARA EL DESARROLLO REGIONAL - LIMA,1,10,CANTA - LIMA,332,LIMA,CANTA,,5,5,5,SI,4,6,MUNICIPAL PROVINCIAL
838,13352,TRABAJO MAS TRABAJO,1,16,OTUZCO - LA LIBERTAD,2884,LA LIBERTAD,OTUZCO,,5,9,7,SI,6,10,MUNICIPAL PROVINCIAL
839,12355,ACCION POPULAR,1,16,ALTO AMAZONAS - LORETO,4,LORETO,ALTO AMAZONAS,,5,8,8,SI,4,12,MUNICIPAL PROVINCIAL
840,13311,PARTIDO POLITICO NACIONAL PERU LIBRE,1,11,JAUJA - JUNIN,2218,JUNIN,JAUJA,,5,6,5,SI,1,10,MUNICIPAL PROVINCIAL
841,12960,ACCION POPULAR,1,12,PUNO - PUNO,4,PUNO,PUNO,,5,7,5,NO,0,12,MUNICIPAL PROVINCIAL
842,13335,CONTIGO REGION,1,20,PIURA - PIURA,2862,PIURA,PIURA,,5,11,9,SI,4,16,MUNICIPAL PROVINCIAL
843,2635,CAJAMARCA SIEMPRE VERDE,1,15,CUTERVO - CAJAMARCA,1464,CAJAMARCA,CUTERVO,,5,8,7,SI,3,12,MUNICIPAL PROVINCIAL
844,13376,REGION PARA TODOS,1,12,SECHURA - PIURA,1411,PIURA,SECHURA,,5,6,6,SI,2,10,MUNICIPAL PROVINCIAL
845,12767,PIURA RENACE,1,13,MORROPON - PIURA,2876,PIURA,MORROPON,,5,7,6,SI,1,12,MUNICIPAL PROVINCIAL
846,5054,ACCION POPULAR,1,12,ANDAHUAYLAS - APURIMAC,4,APURIMAC,ANDAHUAYLAS,,5,7,5,NO,0,12,MUNICIPAL PROVINCIAL
847,12943,PARTIDO POLITICO NACIONAL PERU LIBRE,1,14,CHUMBIVILCAS - CUSCO,2218,CUSCO,CHUMBIVILCAS,,5,8,6,SI,4,10,MUNICIPAL PROVINCIAL
848,13364,NUEVA LIBERTAD,1,18,TRUJILLO - LA LIBERTAD,2232,LA LIBERTAD,TRUJILLO,,5,9,9,SI,2,16,MUNICIPAL PROVINCIAL
849,13394,PARTIDO POLITICO NACIONAL PERU LIBRE,1,12,CONDORCANQUI - AMAZONAS,2218,AMAZONAS,CONDORCANQUI,,5,7,5,SI,4,8,MUNICIPAL PROVINCIAL
850,11298,SOCIOS POR ANCASH,1,11,POMABAMBA - ANCASH,2881,ANCASH,POMABAMBA,,5,6,5,SI,3,8,MUNICIPAL PROVINCIAL
851,13314,PARTIDO MORADO,1,13,JAUJA - JUNIN,2840,JUNIN,JAUJA,,5,7,6,SI,3,10,MUNICIPAL PROVINCIAL
852,13409,CONTIGO REGION,1,18,MORROPON - PIURA,2862,PIURA,MORROPON,,5,9,9,SI,6,12,MUNICIPAL PROVINCIAL
853,12316,ACCION POPULAR,1,12,DATEM DEL MARAÑON - LORETO,4,LORETO,DATEM DEL MARAÑON,,5,7,5,SI,2,10,MUNICIPAL PROVINCIAL
854,13088,SUMATE,2,12,VIRU - LA LIBERTAD,67,LA LIBERTAD,VIRU,,5,7,5,SI,2,10,MUNICIPAL PROVINCIAL
855,13045,PARTIDO PATRIOTICO DEL PERU,1,14,ILO - MOQUEGUA,2869,MOQUEGUA,ILO,,5,7,7,SI,4,10,MUNICIPAL PROVINCIAL
856,5090,ACCION POPULAR,1,8,AYMARAES - APURIMAC,4,APURIMAC,AYMARAES,,5,5,3,NO,0,8,MUNICIPAL PROVINCIAL
857,12393,SUMATE,1,12,PATAZ - LA LIBERTAD,67,LA LIBERTAD,PATAZ,,5,7,5,SI,2,10,MUNICIPAL PROVINCIAL
858,11917,FRENTE AMPLIO PARA EL DESARROLLO DEL PUEBLO,1,11,CARABAYA - PUNO,1670,PUNO,CARABAYA,,5,6,5,SI,1,10,MUNICIPAL PROVINCIAL
859,12910,PARTIDO DEMOCRATICO SOMOS PERU,1,10,EL DORADO - SAN MARTIN,14,SAN MARTIN,EL DORADO,,5,6,4,SI,2,8,MUNICIPAL PROVINCIAL
860,11921,PARTIDO MORADO,1,13,CHEPEN - LA LIBERTAD,2840,LA LIBERTAD,CHEPEN,,5,7,6,SI,3,10,MUNICIPAL PROVINCIAL
861,2192,PARTIDO FRENTE DE LA ESPERANZA 2021,1,12,TARMA - JUNIN,2857,JUNIN,TARMA,,5,7,5,SI,2,10,MUNICIPAL PROVINCIAL
862,13437,MOVIMIENTO REGIONAL AMAZONENSE UNIDOS AL CAMPO,1,15,BONGARA - AMAZONAS,40,AMAZONAS,BONGARA,,5,8,7,SI,7,8,MUNICIPAL PROVINCIAL
863,13391,PARTIDO MORADO,1,15,CHANCHAMAYO - JUNIN,2840,JUNIN,CHANCHAMAYO,,5,8,7,SI,3,12,MUNICIPAL PROVINCIAL
864,9884,PARTIDO FRENTE DE LA ESPERANZA 2021,1,7,VILCAS HUAMAN - AYACUCHO,2857,AYACUCHO,VILCAS HUAMAN,,5,4,3,SI,1,6,MUNICIPAL PROVINCIAL
865,9080,MOVIMIENTO INDEPENDIENTE REGIONAL MI BUEN VECINO,1,11,YAROWILCA - HUANUCO,2730,HUANUCO,YAROWILCA,,5,6,5,SI,5,6,MUNICIPAL PROVINCIAL
866,13118,MOVIMIENTO ACCION REGIONAL,1,10,CHUCUITO - PUNO,2866,PUNO,CHUCUITO,,5,4,6,NO,0,10,MUNICIPAL PROVINCIAL
867,12701,JUNTOS POR EL PERU,1,16,SANTA - ANCASH,1264,ANCASH,SANTA,,5,9,7,SI,2,14,MUNICIPAL PROVINCIAL
868,13360,PARTIDO MORADO,1,16,TACNA - TACNA,2840,TACNA,TACNA,,5,9,7,SI,2,14,MUNICIPAL PROVINCIAL
869,13435,CAJAMARCA SIEMPRE VERDE,1,10,SAN MIGUEL - CAJAMARCA,1464,CAJAMARCA,SAN MIGUEL,,5,6,4,SI,2,8,MUNICIPAL PROVINCIAL
870,13410,RENOVACION POPULAR,1,19,MAYNAS - LORETO,22,LORETO,MAYNAS,,5,10,9,SI,3,16,MUNICIPAL PROVINCIAL
871,13470,PARTIDO FRENTE DE LA ESPERANZA 2021,1,12,SIHUAS - ANCASH,2857,ANCASH,SIHUAS,,5,7,5,SI,4,8,MUNICIPAL PROVINCIAL
872,1109,RENOVACION POPULAR,1,19,CHICLAYO - LAMBAYEQUE,22,LAMBAYEQUE,CHICLAYO,,5,10,9,SI,3,16,MUNICIPAL PROVINCIAL
873,9647,MOVIMIENTO INDEPENDIENTE REGIONAL MI BUEN VECINO,1,10,MARAÑON - HUANUCO,2730,HUANUCO,MARAÑON,,5,6,4,SI,2,8,MUNICIPAL PROVINCIAL
874,13490,PARTIDO POLITICO NACIONAL PERU LIBRE,1,14,PACASMAYO - LA LIBERTAD,2218,LA LIBERTAD,PACASMAYO,,5,8,6,SI,2,12,MUNICIPAL PROVINCIAL
875,13472,UNION REGIONAL,1,16,PICOTA - SAN MARTIN,2722,SAN MARTIN,PICOTA,,5,9,7,SI,8,8,MUNICIPAL PROVINCIAL
876,9804,CAJAMARCA SIEMPRE VERDE,1,16,CHOTA - CAJAMARCA,1464,CAJAMARCA,CHOTA,,5,9,7,SI,4,12,MUNICIPAL PROVINCIAL
877,982,MOVIMIENTO REGIONAL AGUA,1,13,HUAYTARA - HUANCAVELICA,2681,HUANCAVELICA,HUAYTARA,,5,7,6,SI,7,6,MUNICIPAL PROVINCIAL
878,12197,PARTIDO POLITICO NACIONAL PERU LIBRE,1,18,LAMBAYEQUE - LAMBAYEQUE,2218,LAMBAYEQUE,LAMBAYEQUE,,5,9,9,SI,4,14,MUNICIPAL PROVINCIAL
879,13513,MOVIMIENTO REGIONAL REVALORA,1,12,CAYLLOMA - AREQUIPA,2719,AREQUIPA,CAYLLOMA,,5,7,5,SI,2,10,MUNICIPAL PROVINCIAL
880,11438,PARTIDO MORADO,1,10,ISLAY - AREQUIPA,2840,AREQUIPA,ISLAY,,5,6,4,NO,0,10,MUNICIPAL PROVINCIAL
881,13521,FRENTE REGIONAL DE CAJAMARCA,1,16,CHOTA - CAJAMARCA,160,CAJAMARCA,CHOTA,,5,9,7,SI,4,12,MUNICIPAL PROVINCIAL
882,1850,MOVIMIENTO INDEPENDIENTE REGIONAL MI BUEN VECINO,1,22,HUANUCO - HUANUCO,2730,HUANUCO,HUANUCO,,5,12,10,SI,8,14,MUNICIPAL PROVINCIAL
883,13002,PARTIDO DEMOCRATICO SOMOS PERU,1,13,QUISPICANCHI - CUSCO,14,CUSCO,QUISPICANCHI,,5,7,6,SI,3,10,MUNICIPAL PROVINCIAL
884,2149,PARTIDO FRENTE DE LA ESPERANZA 2021,1,12,SATIPO - JUNIN,2857,JUNIN,SATIPO,,5,7,5,NO,0,12,MUNICIPAL PROVINCIAL
885,13367,ALIANZA POR NUESTRO DESARROLLO,1,19,HUANTA - AYACUCHO,2710,AYACUCHO,HUANTA,,5,10,9,SI,9,10,MUNICIPAL PROVINCIAL
886,13506,MOVIMIENTO REGIONAL FUERZA POR MADRE DE DIOS - MR FMDD,1,24,TAMBOPATA - MADRE DE DIOS,2300,MADRE DE DIOS,TAMBOPATA,,5,13,11,SI,12,12,MUNICIPAL PROVINCIAL
887,13537,PARTIDO POLITICO NACIONAL PERU LIBRE,1,10,CHUPACA - JUNIN,2218,JUNIN,CHUPACA,,5,6,4,NO,0,10,MUNICIPAL PROVINCIAL
888,5479,MOVIMIENTO REGIONAL REVALORA,1,8,CARAVELI - AREQUIPA,2719,AREQUIPA,CARAVELI,,5,5,3,NO,0,8,MUNICIPAL PROVINCIAL
889,4928,GESTIONANDO OBRAS Y OPORTUNIDADES CON LIDERAZGO,2,14,CHUCUITO - PUNO,2667,PUNO,CHUCUITO,,5,8,6,SI,4,10,MUNICIPAL PROVINCIAL
890,13559,SUMATE,1,14,ASCOPE - LA LIBERTAD,67,LA LIBERTAD,ASCOPE,,5,8,6,SI,2,12,MUNICIPAL PROVINCIAL
891,13582,ALIANZA PARA EL PROGRESO,1,16,BELLAVISTA - SAN MARTIN,1257,SAN MARTIN,BELLAVISTA,,5,9,7,SI,6,10,MUNICIPAL PROVINCIAL
892,4260,FUERZA AREQUIPEÑA,1,22,AREQUIPA - AREQUIPA,1393,AREQUIPA,AREQUIPA,,5,12,10,SI,6,16,MUNICIPAL PROVINCIAL
893,13476,PARTIDO FRENTE DE LA ESPERANZA 2021,1,16,HUANCAYO - JUNIN,2857,JUNIN,HUANCAYO,,5,9,7,NO,0,16,MUNICIPAL PROVINCIAL
894,11918,PARTIDO POLITICO NACIONAL PERU LIBRE,1,12,LAMPA - PUNO,2218,PUNO,LAMPA,,5,7,5,SI,4,8,MUNICIPAL PROVINCIAL
895,2298,PARTIDO FRENTE DE LA ESPERANZA 2021,1,11,DANIEL ALCIDES CARRION - PASCO,2857,PASCO,DANIEL ALCIDES CARRION,,5,6,5,SI,3,8,MUNICIPAL PROVINCIAL
896,355,PODEMOS PERU,1,9,YAUYOS - LIMA,2731,LIMA,YAUYOS,,5,5,4,SI,3,6,MUNICIPAL PROVINCIAL
897,13612,ALIANZA PARA EL PROGRESO,1,10,HUALLAGA - SAN MARTIN,1257,SAN MARTIN,HUALLAGA,,5,5,5,SI,2,8,MUNICIPAL PROVINCIAL
898,12887,MOVIMIENTO REGIONAL GANA AYACUCHO,1,19,LA MAR - AYACUCHO,2694,AYACUCHO,LA MAR,,5,10,9,SI,9,10,MUNICIPAL PROVINCIAL
899,13162,YO AREQUIPA,1,10,LA UNION - AREQUIPA,2744,AREQUIPA,LA UNION,,5,6,4,SI,4,6,MUNICIPAL PROVINCIAL
900,3736,FUERZA POPULAR,1,12,CHINCHA - ICA,1366,ICA,CHINCHA,,5,7,5,NO,0,12,MUNICIPAL PROVINCIAL
901,50,PODEMOS PERU,1,14,LA CONVENCION - CUSCO,2731,CUSCO,LA CONVENCION,,5,8,6,SI,2,12,MUNICIPAL PROVINCIAL
902,12781,PARTIDO DEMOCRATICO SOMOS PERU,1,16,SULLANA - PIURA,14,PIURA,SULLANA,,5,9,7,SI,2,14,MUNICIPAL PROVINCIAL
903,11856,PARTIDO POLITICO NACIONAL PERU LIBRE,1,10,CANAS - CUSCO,2218,CUSCO,CANAS,,5,6,4,SI,2,8,MUNICIPAL PROVINCIAL
904,11949,PARTIDO POLITICO NACIONAL PERU LIBRE,1,14,CANCHIS - CUSCO,2218,CUSCO,CANCHIS,,5,7,7,SI,2,12,MUNICIPAL PROVINCIAL
905,13639,DEMOCRATA VERDE,1,26,MAYNAS - LORETO,2895,LORETO,MAYNAS,,5,13,13,SI,10,16,MUNICIPAL PROVINCIAL
906,13079,MOVIMIENTO INDEPENDIENTE REGIONAL MI BUEN VECINO,1,10,DOS DE MAYO - HUANUCO,2730,HUANUCO,DOS DE MAYO,,5,5,5,SI,2,8,MUNICIPAL PROVINCIAL
907,9743,CAJAMARCA SIEMPRE VERDE,1,11,HUALGAYOC - CAJAMARCA,1464,CAJAMARCA,HUALGAYOC,,5,6,5,SI,1,10,MUNICIPAL PROVINCIAL
908,5584,JUNTOS POR EL PERU,2,45,LIMA - LIMA,1264,LIMA,LIMA,,5,23,22,SI,5,40,MUNICIPAL PROVINCIAL
909,13719,TRABAJO MAS TRABAJO,1,14,JULCAN - LA LIBERTAD,2884,LA LIBERTAD,JULCAN,,5,8,6,SI,6,8,MUNICIPAL PROVINCIAL
910,13711,PARTIDO DEMOCRATICO SOMOS PERU,2,12,ANTA - CUSCO,14,CUSCO,ANTA,,5,6,6,SI,2,10,MUNICIPAL PROVINCIAL
911,292,PODEMOS PERU,1,12,OXAPAMPA - PASCO,2731,PASCO,OXAPAMPA,,5,7,5,SI,2,10,MUNICIPAL PROVINCIAL
912,2369,PARTIDO FRENTE DE LA ESPERANZA 2021,1,12,OXAPAMPA - PASCO,2857,PASCO,OXAPAMPA,,5,6,6,SI,2,10,MUNICIPAL PROVINCIAL
913,13742,ALIANZA PARA EL PROGRESO,1,12,MARISCAL CACERES - SAN MARTIN,1257,SAN MARTIN,MARISCAL CACERES,,5,7,5,SI,2,10,MUNICIPAL PROVINCIAL
914,13021,PARTIDO DEMOCRATICO SOMOS PERU,1,12,TAMBOPATA - MADRE DE DIOS,14,MADRE DE DIOS,TAMBOPATA,,5,7,5,NO,0,12,MUNICIPAL PROVINCIAL
915,8530,FE EN EL PERU,1,13,CHANCHAMAYO - JUNIN,2898,JUNIN,CHANCHAMAYO,,5,7,6,SI,1,12,MUNICIPAL PROVINCIAL
916,12788,ALIANZA PARA EL PROGRESO,1,14,LUYA - AMAZONAS,1257,AMAZONAS,LUYA,,5,8,6,SI,6,8,MUNICIPAL PROVINCIAL
917,11659,ALIANZA PARA EL PROGRESO,1,19,PASCO - PASCO,1257,PASCO,PASCO,,5,10,9,SI,7,12,MUNICIPAL PROVINCIAL
918,11650,ALIANZA PARA EL PROGRESO,1,14,UCAYALI - LORETO,1257,LORETO,UCAYALI,,5,7,7,SI,4,10,MUNICIPAL PROVINCIAL
919,11637,ALIANZA PARA EL PROGRESO,1,14,REQUENA - LORETO,1257,LORETO,REQUENA,,5,8,6,SI,4,10,MUNICIPAL PROVINCIAL
920,13745,RENOVACION POPULAR,1,10,JAUJA - JUNIN,22,JUNIN,JAUJA,,5,6,4,NO,0,10,MUNICIPAL PROVINCIAL
921,13767,FRENTE REGIONAL DE CAJAMARCA,1,14,SAN MARCOS - CAJAMARCA,160,CAJAMARCA,SAN MARCOS,,5,8,6,SI,4,10,MUNICIPAL PROVINCIAL
922,11632,ALIANZA PARA EL PROGRESO,1,8,PUTUMAYO - LORETO,1257,LORETO,PUTUMAYO,,5,5,3,SI,2,6,MUNICIPAL PROVINCIAL
923,11577,ALIANZA PARA EL PROGRESO,1,12,CONDORCANQUI - AMAZONAS,1257,AMAZONAS,CONDORCANQUI,,5,6,6,SI,4,8,MUNICIPAL PROVINCIAL
924,11616,ALIANZA PARA EL PROGRESO,1,14,MARISCAL RAMON CASTILLA - LORETO,1257,LORETO,MARISCAL RAMON CASTILLA,,5,7,7,SI,4,10,MUNICIPAL PROVINCIAL
925,13686,TODOS POR EL GRAN CAMBIO,1,8,LAURICOCHA - HUANUCO,2712,HUANUCO,LAURICOCHA,,5,5,3,SI,2,6,MUNICIPAL PROVINCIAL
926,11595,ALIANZA PARA EL PROGRESO,1,12,LORETO - LORETO,1257,LORETO,LORETO,,5,6,6,SI,2,10,MUNICIPAL PROVINCIAL
927,11547,ALIANZA PARA EL PROGRESO,1,10,BAGUA - AMAZONAS,1257,AMAZONAS,BAGUA,,5,6,4,NO,0,10,MUNICIPAL PROVINCIAL
928,11585,ALIANZA PARA EL PROGRESO,1,14,DATEM DEL MARAÑON - LORETO,1257,LORETO,DATEM DEL MARAÑON,,5,8,6,SI,4,10,MUNICIPAL PROVINCIAL
929,11487,ALIANZA PARA EL PROGRESO,1,16,UTCUBAMBA - AMAZONAS,1257,AMAZONAS,UTCUBAMBA,,5,9,7,SI,4,12,MUNICIPAL PROVINCIAL
930,11566,ALIANZA PARA EL PROGRESO,1,16,ALTO AMAZONAS - LORETO,1257,LORETO,ALTO AMAZONAS,,5,8,8,SI,4,12,MUNICIPAL PROVINCIAL
931,11215,ALIANZA PARA EL PROGRESO,1,16,SAN MARTIN - SAN MARTIN,1257,SAN MARTIN,SAN MARTIN,,5,8,8,SI,4,12,MUNICIPAL PROVINCIAL
932,13748,MOVIMIENTO ACCION NACIONALISTA PERUANO,1,7,CARLOS FERMIN FITZCARRALD - ANCASH,360,ANCASH,CARLOS FERMIN FITZCARRALD,,5,4,3,SI,1,6,MUNICIPAL PROVINCIAL
933,11628,PARTIDO POLITICO NACIONAL PERU LIBRE,1,14,ANGARAES - HUANCAVELICA,2218,HUANCAVELICA,ANGARAES,,5,8,6,SI,4,10,MUNICIPAL PROVINCIAL
934,2540,PARTIDO FRENTE DE LA ESPERANZA 2021,1,12,CHUMBIVILCAS - CUSCO,2857,CUSCO,CHUMBIVILCAS,,5,7,5,SI,2,10,MUNICIPAL PROVINCIAL
935,11175,ALIANZA PARA EL PROGRESO,1,8,CAJATAMBO - LIMA,1257,LIMA,CAJATAMBO,,5,4,4,SI,2,6,MUNICIPAL PROVINCIAL
936,13242,ACCION POPULAR,1,14,TAMBOPATA - MADRE DE DIOS,4,MADRE DE DIOS,TAMBOPATA,,5,8,6,SI,2,12,MUNICIPAL PROVINCIAL
937,13805,PODEMOS PERU,1,14,HUALGAYOC - CAJAMARCA,2731,CAJAMARCA,HUALGAYOC,,5,8,6,SI,4,10,MUNICIPAL PROVINCIAL
938,13694,PARTIDO DEMOCRATICO SOMOS PERU,1,6,ASUNCION - ANCASH,14,ANCASH,ASUNCION,,5,3,3,NO,0,6,MUNICIPAL PROVINCIAL
939,13776,FRENTE POPULAR AGRICOLA FIA DEL PERU,1,14,HUARAZ - ANCASH,2901,ANCASH,HUARAZ,,5,7,7,SI,2,12,MUNICIPAL PROVINCIAL
940,11161,ALIANZA PARA EL PROGRESO,1,19,PADRE ABAD - UCAYALI,1257,UCAYALI,PADRE ABAD,,5,10,9,SI,9,10,MUNICIPAL PROVINCIAL
941,12790,ALIANZA PARA EL PROGRESO,1,19,MAYNAS - LORETO,1257,LORETO,MAYNAS,,5,9,10,SI,3,16,MUNICIPAL PROVINCIAL
942,11149,ALIANZA PARA EL PROGRESO,1,17,OXAPAMPA - PASCO,1257,PASCO,OXAPAMPA,,5,9,8,SI,7,10,MUNICIPAL PROVINCIAL
943,13777,MOVIMIENTO INDEPENDIENTE TRABAJANDO PARA TODOS,2,15,TAYACAJA - HUANCAVELICA,226,HUANCAVELICA,TAYACAJA,,5,8,7,SI,5,10,MUNICIPAL PROVINCIAL
944,11115,ALIANZA PARA EL PROGRESO,1,14,LAMAS - SAN MARTIN,1257,SAN MARTIN,LAMAS,,5,8,6,SI,4,10,MUNICIPAL PROVINCIAL
945,7571,AVANZA PAIS - PARTIDO DE INTEGRACION SOCIAL,1,16,LAMBAYEQUE - LAMBAYEQUE,2173,LAMBAYEQUE,LAMBAYEQUE,,5,9,7,SI,2,14,MUNICIPAL PROVINCIAL
946,11107,ALIANZA PARA EL PROGRESO,1,11,RODRIGUEZ DE MENDOZA - AMAZONAS,1257,AMAZONAS,RODRIGUEZ DE MENDOZA,,5,6,5,SI,3,8,MUNICIPAL PROVINCIAL
947,11093,ALIANZA PARA EL PROGRESO,1,15,CHACHAPOYAS - AMAZONAS,1257,AMAZONAS,CHACHAPOYAS,,5,8,7,SI,5,10,MUNICIPAL PROVINCIAL
948,13749,MOVIMIENTO REGIONAL CONSTRUYENDO,1,22,CHICLAYO - LAMBAYEQUE,1442,LAMBAYEQUE,CHICLAYO,,5,12,10,SI,6,16,MUNICIPAL PROVINCIAL
949,2980,PARTIDO FRENTE DE LA ESPERANZA 2021,1,12,COTABAMBAS - APURIMAC,2857,APURIMAC,COTABAMBAS,,5,7,5,SI,2,10,MUNICIPAL PROVINCIAL
950,11203,MOVIMIENTO REGIONAL CONSTRUYENDO,1,16,FERREÑAFE - LAMBAYEQUE,1442,LAMBAYEQUE,FERREÑAFE,,5,9,7,SI,4,12,MUNICIPAL PROVINCIAL
951,13567,MOVIMIENTO REGIONAL BICENTENARIO,1,17,TRUJILLO - LA LIBERTAD,2906,LA LIBERTAD,TRUJILLO,,5,9,8,SI,1,16,MUNICIPAL PROVINCIAL
952,13818,SUMATE,1,10,GRAN CHIMU - LA LIBERTAD,67,LA LIBERTAD,GRAN CHIMU,,5,4,6,SI,2,8,MUNICIPAL PROVINCIAL
953,13808,ALIANZA POR NUESTRO DESARROLLO,1,8,PAUCAR DEL SARA SARA - AYACUCHO,2710,AYACUCHO,PAUCAR DEL SARA SARA,,5,5,3,SI,2,6,MUNICIPAL PROVINCIAL
954,8459,FE EN EL PERU,1,10,CHUPACA - JUNIN,2898,JUNIN,CHUPACA,,5,6,4,NO,0,10,MUNICIPAL PROVINCIAL
955,13250,JUNIN SOSTENIBLE CON SU GENTE,1,20,CONCEPCION - JUNIN,303,JUNIN,CONCEPCION,,5,10,10,SI,10,10,MUNICIPAL PROVINCIAL
956,9845,AVANZA PAIS - PARTIDO DE INTEGRACION SOCIAL,1,48,LIMA - LIMA,2173,LIMA,LIMA,,5,25,23,SI,8,40,MUNICIPAL PROVINCIAL
957,13823,PARTIDO DEMOCRATICO SOMOS PERU,1,14,CANCHIS - CUSCO,14,CUSCO,CANCHIS,,5,8,6,SI,2,12,MUNICIPAL PROVINCIAL
958,13831,PARTIDO DEMOCRATICO SOMOS PERU,1,10,HUAMALIES - HUANUCO,14,HUANUCO,HUAMALIES,,5,6,4,NO,0,10,MUNICIPAL PROVINCIAL
959,13888,ALIANZA PARA EL PROGRESO,1,17,HUANTA - AYACUCHO,1257,AYACUCHO,HUANTA,,5,9,8,SI,7,10,MUNICIPAL PROVINCIAL
960,13855,ALIANZA PARA EL PROGRESO,1,11,CANGALLO - AYACUCHO,1257,AYACUCHO,CANGALLO,,5,6,5,SI,3,8,MUNICIPAL PROVINCIAL
961,13853,MOVIMIENTO ACCION NACIONALISTA PERUANO,1,16,CASMA - ANCASH,360,ANCASH,CASMA,,5,9,7,SI,6,10,MUNICIPAL PROVINCIAL
962,13897,ALIANZA PARA EL PROGRESO,1,13,LUCANAS - AYACUCHO,1257,AYACUCHO,LUCANAS,,5,7,6,SI,3,10,MUNICIPAL PROVINCIAL
963,11417,ALIANZA PARA EL PROGRESO,1,16,CASMA - ANCASH,1257,ANCASH,CASMA,,5,8,8,SI,6,10,MUNICIPAL PROVINCIAL
964,13691,ALIANZA PARA EL PROGRESO,1,16,HUAMANGA - AYACUCHO,1257,AYACUCHO,HUAMANGA,,5,8,8,SI,4,12,MUNICIPAL PROVINCIAL
965,13732,YO AREQUIPA,1,19,CAYLLOMA - AREQUIPA,2744,AREQUIPA,CAYLLOMA,,5,10,9,SI,9,10,MUNICIPAL PROVINCIAL
966,13896,AVANZA PAIS - PARTIDO DE INTEGRACION SOCIAL,1,9,CASTILLA - AREQUIPA,2173,AREQUIPA,CASTILLA,,5,5,4,SI,1,8,MUNICIPAL PROVINCIAL
967,10375,PARTIDO MORADO,1,12,HUANCAVELICA - HUANCAVELICA,2840,HUANCAVELICA,HUANCAVELICA,,5,7,5,NO,0,12,MUNICIPAL PROVINCIAL
968,11393,ALIANZA PARA EL PROGRESO,1,14,OTUZCO - LA LIBERTAD,1257,LA LIBERTAD,OTUZCO,,5,8,6,SI,4,10,MUNICIPAL PROVINCIAL
969,11395,ALIANZA PARA EL PROGRESO,1,14,PACASMAYO - LA LIBERTAD,1257,LA LIBERTAD,PACASMAYO,,5,8,6,SI,2,12,MUNICIPAL PROVINCIAL
970,11408,ALIANZA PARA EL PROGRESO,1,18,TRUJILLO - LA LIBERTAD,1257,LA LIBERTAD,TRUJILLO,,5,10,8,SI,2,16,MUNICIPAL PROVINCIAL
971,13919,ALIANZA PARA EL PROGRESO,1,8,PAUCAR DEL SARA SARA - AYACUCHO,1257,AYACUCHO,PAUCAR DEL SARA SARA,,5,5,3,SI,2,6,MUNICIPAL PROVINCIAL
972,11658,ALIANZA PARA EL PROGRESO,2,29,TRUJILLO - LA LIBERTAD,1257,LA LIBERTAD,TRUJILLO,,5,15,14,SI,13,16,MUNICIPAL PROVINCIAL
973,12970,ALIANZA PARA EL PROGRESO,1,13,CHINCHEROS - APURIMAC,1257,APURIMAC,CHINCHEROS,,5,7,6,SI,5,8,MUNICIPAL PROVINCIAL
974,12975,ALIANZA PARA EL PROGRESO,1,14,COTABAMBAS - APURIMAC,1257,APURIMAC,COTABAMBAS,,5,8,6,SI,4,10,MUNICIPAL PROVINCIAL
975,12983,ALIANZA PARA EL PROGRESO,1,23,ANDAHUAYLAS - APURIMAC,1257,APURIMAC,ANDAHUAYLAS,,5,12,11,SI,11,12,MUNICIPAL PROVINCIAL
976,13485,PARTIDO POLITICO NACIONAL PERU LIBRE,1,12,CHANCHAMAYO - JUNIN,2218,JUNIN,CHANCHAMAYO,,5,6,6,NO,0,12,MUNICIPAL PROVINCIAL
977,11404,ACCION POPULAR,1,14,SANTA - ANCASH,4,ANCASH,SANTA,,5,7,7,NO,0,14,MUNICIPAL PROVINCIAL
978,13929,DEMOCRATA VERDE,1,12,CHOTA - CAJAMARCA,2895,CAJAMARCA,CHOTA,,5,7,5,NO,0,12,MUNICIPAL PROVINCIAL
979,8851,MOVIMIENTO REGIONAL AYNI,1,19,ANGARAES - HUANCAVELICA,136,HUANCAVELICA,ANGARAES,,5,10,9,SI,9,10,MUNICIPAL PROVINCIAL
980,11413,ACCION POPULAR,1,9,CARHUAZ - ANCASH,4,ANCASH,CARHUAZ,,5,5,4,SI,1,8,MUNICIPAL PROVINCIAL
981,8191,PARTIDO MORADO,1,14,HUAMANGA - AYACUCHO,2840,AYACUCHO,HUAMANGA,,5,8,6,SI,2,12,MUNICIPAL PROVINCIAL
982,2073,ACCION POPULAR,1,11,ANTA - CUSCO,4,CUSCO,ANTA,,5,6,5,SI,1,10,MUNICIPAL PROVINCIAL
983,12540,ALIANZA PARA EL PROGRESO,1,15,SECHURA - PIURA,1257,PIURA,SECHURA,,5,8,7,SI,5,10,MUNICIPAL PROVINCIAL
984,11473,ACCION POPULAR,1,10,HUARMEY - ANCASH,4,ANCASH,HUARMEY,,5,5,5,SI,2,8,MUNICIPAL PROVINCIAL
985,12479,ALIANZA PARA EL PROGRESO,1,14,TALARA - PIURA,1257,PIURA,TALARA,,5,8,6,SI,2,12,MUNICIPAL PROVINCIAL
986,13957,PARTIDO FRENTE DE LA ESPERANZA 2021,1,16,CUSCO - CUSCO,2857,CUSCO,CUSCO,,5,9,7,SI,2,14,MUNICIPAL PROVINCIAL
987,12465,ALIANZA PARA EL PROGRESO,1,18,SULLANA - PIURA,1257,PIURA,SULLANA,,5,9,9,SI,4,14,MUNICIPAL PROVINCIAL
988,12455,ALIANZA PARA EL PROGRESO,1,16,MORROPON - PIURA,1257,PIURA,MORROPON,,5,8,8,SI,4,12,MUNICIPAL PROVINCIAL
989,13955,MOVIMIENTO DE INTEGRACION Y REVOLUCION ANDINA,1,12,LAMPA - PUNO,2702,PUNO,LAMPA,,5,7,5,SI,4,8,MUNICIPAL PROVINCIAL
990,13926,MOVIMIENTO INDEPENDIENTE REGIONAL MI BUEN VECINO,1,16,LEONCIO PRADO - HUANUCO,2730,HUANUCO,LEONCIO PRADO,,5,8,8,SI,4,12,MUNICIPAL PROVINCIAL
991,13920,FE EN EL PERU,1,10,ZARUMILLA - TUMBES,2898,TUMBES,ZARUMILLA,,5,5,5,NO,0,10,MUNICIPAL PROVINCIAL
992,10981,AVANZA PAIS - PARTIDO DE INTEGRACION SOCIAL,1,9,CONTUMAZA - CAJAMARCA,2173,CAJAMARCA,CONTUMAZA,,5,5,4,SI,1,8,MUNICIPAL PROVINCIAL
993,10670,PARTIDO PATRIOTICO DEL PERU,1,12,AYABACA - PIURA,2869,PIURA,AYABACA,,5,7,5,NO,0,12,MUNICIPAL PROVINCIAL
994,9417,ALIANZA POR NUESTRO DESARROLLO,1,18,PARINACOCHAS - AYACUCHO,2710,AYACUCHO,PARINACOCHAS,,5,10,8,SI,10,8,MUNICIPAL PROVINCIAL
995,9686,MOVIMIENTO REGIONAL AGUA,1,9,CHURCAMPA - HUANCAVELICA,2681,HUANCAVELICA,CHURCAMPA,,5,4,5,SI,1,8,MUNICIPAL PROVINCIAL
996,12909,DEMOCRATA VERDE,1,14,SANTA - ANCASH,2895,ANCASH,SANTA,,5,8,6,NO,0,14,MUNICIPAL PROVINCIAL
997,12671,DEMOCRATA VERDE,1,14,ASCOPE - LA LIBERTAD,2895,LA LIBERTAD,ASCOPE,,5,8,6,SI,2,12,MUNICIPAL PROVINCIAL
998,13906,PARTIDO POLITICO NACIONAL PERU LIBRE,1,16,HUANCAVELICA - HUANCAVELICA,2218,HUANCAVELICA,HUANCAVELICA,,5,9,7,SI,4,12,MUNICIPAL PROVINCIAL
999,10831,PARTIDO POLITICO NACIONAL PERU LIBRE,1,20,TACNA - TACNA,2218,TACNA,TACNA,,5,11,9,SI,6,14,MUNICIPAL PROVINCIAL
1000,11739,DEMOCRATA VERDE,1,16,TRUJILLO - LA LIBERTAD,2895,LA LIBERTAD,TRUJILLO,,5,9,7,NO,0,16,MUNICIPAL PROVINCIAL
1001,11698,DEMOCRATA VERDE,1,14,SULLANA - PIURA,2895,PIURA,SULLANA,,5,7,7,NO,0,14,MUNICIPAL PROVINCIAL
1002,11370,DEMOCRATA VERDE,2,14,TACNA - TACNA,2895,TACNA,TACNA,,5,8,6,NO,0,14,MUNICIPAL PROVINCIAL
1003,11335,DEMOCRATA VERDE,1,18,TACNA - TACNA,2895,TACNA,TACNA,,5,9,9,SI,4,14,MUNICIPAL PROVINCIAL
1004,14005,PARTIDO DEMOCRATICO SOMOS PERU,1,10,AMBO - HUANUCO,14,HUANUCO,AMBO,,5,6,4,NO,0,10,MUNICIPAL PROVINCIAL
1005,11302,DEMOCRATA VERDE,1,11,HUALGAYOC - CAJAMARCA,2895,CAJAMARCA,HUALGAYOC,,5,6,5,SI,1,10,MUNICIPAL PROVINCIAL
1006,14032,SOMOS PUEBLO,1,19,PUNO - PUNO,2657,PUNO,PUNO,,5,10,9,SI,7,12,MUNICIPAL PROVINCIAL
1007,14043,ALIANZA PARA EL PROGRESO,1,14,TOCACHE - SAN MARTIN,1257,SAN MARTIN,TOCACHE,,5,8,6,SI,4,10,MUNICIPAL PROVINCIAL
1008,10689,DEMOCRATA VERDE,1,13,BARRANCA - LIMA,2895,LIMA,BARRANCA,,5,7,6,SI,1,12,MUNICIPAL PROVINCIAL
1009,13899,PARTIDO DEMOCRATICO SOMOS PERU,1,8,CARHUAZ - ANCASH,14,ANCASH,CARHUAZ,,5,4,4,NO,0,8,MUNICIPAL PROVINCIAL
1010,4079,JUNTOS POR EL PERU,1,10,LUCANAS - AYACUCHO,1264,AYACUCHO,LUCANAS,,5,5,5,NO,0,10,MUNICIPAL PROVINCIAL
1011,4693,FUERZA POPULAR,1,10,VIRU - LA LIBERTAD,1366,LA LIBERTAD,VIRU,,5,6,4,NO,0,10,MUNICIPAL PROVINCIAL
1012,14064,PODEMOS PERU,1,12,HUANCANE - PUNO,2731,PUNO,HUANCANE,,5,7,5,SI,2,10,MUNICIPAL PROVINCIAL
1013,4689,FUERZA POPULAR,1,12,SANCHEZ CARRION - LA LIBERTAD,1366,LA LIBERTAD,SANCHEZ CARRION,,5,7,5,NO,0,12,MUNICIPAL PROVINCIAL
1014,9975,FRENTE POPULAR AGRICOLA FIA DEL PERU,1,15,CANCHIS - CUSCO,2901,CUSCO,CANCHIS,,5,8,7,SI,3,12,MUNICIPAL PROVINCIAL
1015,14009,PARTIDO DEMOCRATICO SOMOS PERU,1,20,ALTO AMAZONAS - LORETO,14,LORETO,ALTO AMAZONAS,,5,11,9,SI,8,12,MUNICIPAL PROVINCIAL
1016,42,PODEMOS PERU,1,10,ESPINAR - CUSCO,2731,CUSCO,ESPINAR,,5,6,4,NO,0,10,MUNICIPAL PROVINCIAL
1017,7660,PARTIDO POLITICO NACIONAL PERU LIBRE,1,8,PALLASCA - ANCASH,2218,ANCASH,PALLASCA,,5,5,3,NO,0,8,MUNICIPAL PROVINCIAL
1018,4677,FUERZA POPULAR,1,16,TRUJILLO - LA LIBERTAD,1366,LA LIBERTAD,TRUJILLO,,5,9,7,NO,0,16,MUNICIPAL PROVINCIAL
1019,1191,MOVIMENTO INDEPENDIENTE REGIONAL FUERZA TACNA,1,7,TARATA - TACNA,2432,TACNA,TARATA,,5,4,3,SI,1,6,MUNICIPAL PROVINCIAL
1020,8667,DEMOCRATA VERDE,1,12,MORROPON - PIURA,2895,PIURA,MORROPON,,5,6,6,NO,0,12,MUNICIPAL PROVINCIAL
1021,3511,FUERZA POPULAR,1,10,CHEPEN - LA LIBERTAD,1366,LA LIBERTAD,CHEPEN,,5,5,5,NO,0,10,MUNICIPAL PROVINCIAL
1022,2942,FUERZA POPULAR,1,13,PACASMAYO - LA LIBERTAD,1366,LA LIBERTAD,PACASMAYO,,5,7,6,SI,1,12,MUNICIPAL PROVINCIAL
1023,13265,MOVIMIENTO REGIONAL INKA PACHAKUTEQ,1,8,PAUCARTAMBO - CUSCO,2368,CUSCO,PAUCARTAMBO,,5,5,3,NO,0,8,MUNICIPAL PROVINCIAL
1024,8730,GESTIONANDO OBRAS Y OPORTUNIDADES CON LIDERAZGO,2,15,SAN ROMAN - PUNO,2667,PUNO,SAN ROMAN,,5,7,8,SI,1,14,MUNICIPAL PROVINCIAL
1025,5739,FRENTE POPULAR AGRICOLA FIA DEL PERU,1,12,TARMA - JUNIN,2901,JUNIN,TARMA,,5,6,6,SI,2,10,MUNICIPAL PROVINCIAL
1026,2929,FUERZA POPULAR,1,9,GRAN CHIMU - LA LIBERTAD,1366,LA LIBERTAD,GRAN CHIMU,,5,5,4,SI,1,8,MUNICIPAL PROVINCIAL
1027,14087,ALIANZA PARA EL PROGRESO,1,9,VICTOR FAJARDO - AYACUCHO,1257,AYACUCHO,VICTOR FAJARDO,,5,5,4,SI,3,6,MUNICIPAL PROVINCIAL
1028,3346,PARTIDO FRENTE DE LA ESPERANZA 2021,1,14,HUALGAYOC - CAJAMARCA,2857,CAJAMARCA,HUALGAYOC,,5,8,6,SI,4,10,MUNICIPAL PROVINCIAL
1029,2911,FUERZA POPULAR,1,12,ASCOPE - LA LIBERTAD,1366,LA LIBERTAD,ASCOPE,,5,6,6,NO,0,12,MUNICIPAL PROVINCIAL
1030,13975,MOVIMIENTO DE INTEGRACION POR EL DESARROLLO REGIONAL (MI CASITA),1,13,MELGAR - PUNO,2668,PUNO,MELGAR,,5,7,6,SI,3,10,MUNICIPAL PROVINCIAL
1031,14070,MOVIMIENTO REGIONAL AGUA,1,13,LUCANAS - AYACUCHO,2861,AYACUCHO,LUCANAS,,5,7,6,SI,3,10,MUNICIPAL PROVINCIAL
1032,14026,PARTIDO MORADO,1,20,CHICLAYO - LAMBAYEQUE,2840,LAMBAYEQUE,CHICLAYO,,5,11,9,SI,4,16,MUNICIPAL PROVINCIAL
1033,13637,PARTIDO PATRIOTICO DEL PERU,2,18,CHICLAYO - LAMBAYEQUE,2869,LAMBAYEQUE,CHICLAYO,,5,9,9,SI,2,16,MUNICIPAL PROVINCIAL
1034,7614,CORAZON PATRIOTA,1,14,CONCEPCION - JUNIN,2729,JUNIN,CONCEPCION,,5,8,6,SI,4,10,MUNICIPAL PROVINCIAL
1035,14101,CAMINEMOS JUNTOS POR JUNIN,1,10,YAULI - JUNIN,122,JUNIN,YAULI,,5,6,4,SI,2,8,MUNICIPAL PROVINCIAL
1036,14131,JUNIN RENACE,1,12,TARMA - JUNIN,2716,JUNIN,TARMA,,5,7,5,SI,2,10,MUNICIPAL PROVINCIAL
1037,14099,PARTIDO MORADO,1,15,ABANCAY - APURIMAC,2840,APURIMAC,ABANCAY,,5,8,7,SI,3,12,MUNICIPAL PROVINCIAL
1038,2826,FUERZA POPULAR,1,19,AREQUIPA - AREQUIPA,1366,AREQUIPA,AREQUIPA,,5,10,9,SI,3,16,MUNICIPAL PROVINCIAL
1039,13271,PARTIDO POLITICO NACIONAL PERU LIBRE,1,12,TARMA - JUNIN,2218,JUNIN,TARMA,,5,6,6,SI,2,10,MUNICIPAL PROVINCIAL
1040,13914,AVANZA PAIS - PARTIDO DE INTEGRACION SOCIAL,1,16,SANTA - ANCASH,2173,ANCASH,SANTA,,5,9,7,SI,2,14,MUNICIPAL PROVINCIAL
1041,11618,FRENTE AMPLIO PARA EL DESARROLLO DEL PUEBLO,1,12,YUNGUYO - PUNO,1670,PUNO,YUNGUYO,,5,7,5,SI,4,8,MUNICIPAL PROVINCIAL
1042,12030,PARTIDO MORADO,1,14,CORONEL PORTILLO - UCAYALI,2840,UCAYALI,CORONEL PORTILLO,,5,7,7,NO,0,14,MUNICIPAL PROVINCIAL
1043,11080,MOVIMIENTO REGIONAL SIERRA Y SELVA CONTIGO JUNIN,1,18,TARMA - JUNIN,2680,JUNIN,TARMA,,5,10,8,SI,8,10,MUNICIPAL PROVINCIAL
1044,14189,ALIANZA PARA EL PROGRESO,1,11,MANU - MADRE DE DIOS,1257,MADRE DE DIOS,MANU,,5,6,5,SI,5,6,MUNICIPAL PROVINCIAL
1045,14176,MOVIMIENTO ACCION NACIONALISTA PERUANO,1,16,SANTA - ANCASH,360,ANCASH,SANTA,,5,9,7,SI,2,14,MUNICIPAL PROVINCIAL
1046,14183,PARTIDO POLITICO NACIONAL PERU LIBRE,1,10,CHURCAMPA - HUANCAVELICA,2218,HUANCAVELICA,CHURCAMPA,,5,5,5,SI,2,8,MUNICIPAL PROVINCIAL
1047,14178,PASCO DIGNIDAD,1,10,DANIEL ALCIDES CARRION - PASCO,1705,PASCO,DANIEL ALCIDES CARRION,,5,6,4,SI,2,8,MUNICIPAL PROVINCIAL
1048,4171,MOVIMIENTO INDEPENDIENTE POLITICO VOLUNTAD GENERAL AMAZONICA - VOGA ,1,19,MAYNAS - LORETO,2333,LORETO,MAYNAS,,5,10,9,SI,3,16,MUNICIPAL PROVINCIAL
1049,14175,MOVIMIENTO POLITICO REGIONAL SUMATE AL CAMBIO,1,13,MARISCAL NIETO - MOQUEGUA,2891,MOQUEGUA,MARISCAL NIETO,,5,7,6,SI,3,10,MUNICIPAL PROVINCIAL
1050,14193,MOVIMIENTO DE INTEGRACION Y REVOLUCION ANDINA,1,13,EL COLLAO - PUNO,2702,PUNO,EL COLLAO,,5,7,6,SI,3,10,MUNICIPAL PROVINCIAL
1051,14201,ALIANZA PARA EL PROGRESO,1,6,TAHUAMANU - MADRE DE DIOS,1257,MADRE DE DIOS,TAHUAMANU,,5,4,2,NO,0,6,MUNICIPAL PROVINCIAL
1052,13821,PARTIDO POLITICO NACIONAL PERU LIBRE,1,14,PAUCARTAMBO - CUSCO,2218,CUSCO,PAUCARTAMBO,,5,8,6,SI,6,8,MUNICIPAL PROVINCIAL
1053,93,PODEMOS PERU,1,11,PAUCARTAMBO - CUSCO,2731,CUSCO,PAUCARTAMBO,,5,6,5,SI,3,8,MUNICIPAL PROVINCIAL
1054,1597,JUNTOS POR EL PERU,1,8,SANTA CRUZ - CAJAMARCA,1264,CAJAMARCA,SANTA CRUZ,,5,5,3,NO,0,8,MUNICIPAL PROVINCIAL
1055,14223,MOVIMIENTO POLITICO CAMBIEMOS X HCO,1,12,AMBO - HUANUCO,2733,HUANUCO,AMBO,,5,6,6,SI,2,10,MUNICIPAL PROVINCIAL
1056,5811,JUNIN SOSTENIBLE CON SU GENTE,1,6,JUNIN - JUNIN,303,JUNIN,JUNIN,,5,3,3,NO,0,6,MUNICIPAL PROVINCIAL
1057,10625,MOVIMIENTO REGIONAL FORTALEZA PERU,1,18,OTUZCO - LA LIBERTAD,2738,LA LIBERTAD,OTUZCO,,5,10,8,SI,8,10,MUNICIPAL PROVINCIAL
1058,14243,PARTIDO DEMOCRATICO SOMOS PERU,1,10,PARURO - CUSCO,14,CUSCO,PARURO,,5,6,4,SI,2,8,MUNICIPAL PROVINCIAL
1059,6146,FUERZA POPULAR,1,6,PALPA - ICA,1366,ICA,PALPA,,5,4,2,NO,0,6,MUNICIPAL PROVINCIAL
1060,13994,PARTIDO DEMOCRATICO SOMOS PERU,1,10,CHINCHEROS - APURIMAC,14,APURIMAC,CHINCHEROS,,5,5,5,SI,2,8,MUNICIPAL PROVINCIAL
1061,1047,PODEMOS PERU,1,11,URUBAMBA - CUSCO,2731,CUSCO,URUBAMBA,,5,6,5,SI,1,10,MUNICIPAL PROVINCIAL
1062,13898,VAMOS POR TACNA,1,16,TACNA - TACNA,2908,TACNA,TACNA,,5,7,9,SI,2,14,MUNICIPAL PROVINCIAL
1063,8535,FE EN EL PERU,1,16,HUANCAYO - JUNIN,2898,JUNIN,HUANCAYO,,5,9,7,NO,0,16,MUNICIPAL PROVINCIAL
1064,14287,MOVIMIENTO REGIONAL WARI LLAQTA,1,7,PAUCAR DEL SARA SARA - AYACUCHO,2706,AYACUCHO,PAUCAR DEL SARA SARA,,5,4,3,SI,1,6,MUNICIPAL PROVINCIAL
1065,6284,PARTIDO DEMOCRATICO SOMOS PERU,1,10,DANIEL ALCIDES CARRION - PASCO,14,PASCO,DANIEL ALCIDES CARRION,,5,6,4,SI,2,8,MUNICIPAL PROVINCIAL
1066,3448,PARTIDO FRENTE DE LA ESPERANZA 2021,1,16,ABANCAY - APURIMAC,2857,APURIMAC,ABANCAY,,5,9,7,SI,4,12,MUNICIPAL PROVINCIAL
1067,12149,PARTIDO FRENTE DE LA ESPERANZA 2021,1,44,LIMA - LIMA,2857,LIMA,LIMA,,5,21,23,SI,4,40,MUNICIPAL PROVINCIAL
1068,1031,JUNTOS POR EL PERU,1,20,CORONEL PORTILLO - UCAYALI,1264,UCAYALI,CORONEL PORTILLO,,5,10,10,SI,6,14,MUNICIPAL PROVINCIAL
1069,14329,PARTIDO POLITICO NACIONAL PERU LIBRE,1,12,ISLAY - AREQUIPA,2218,AREQUIPA,ISLAY,,5,6,6,SI,2,10,MUNICIPAL PROVINCIAL
1070,14351,ALIANZA PARA EL PROGRESO,1,19,PIURA - PIURA,1257,PIURA,PIURA,,5,10,9,SI,3,16,MUNICIPAL PROVINCIAL
1071,8681,JUNIN SOSTENIBLE CON SU GENTE,1,26,HUANCAYO - JUNIN,303,JUNIN,HUANCAYO,,5,13,13,SI,10,16,MUNICIPAL PROVINCIAL
1072,13603,PARTIDO POLITICO NACIONAL PERU LIBRE,1,10,ACOMAYO - CUSCO,2218,CUSCO,ACOMAYO,,5,6,4,SI,4,6,MUNICIPAL PROVINCIAL
1073,627,PODEMOS PERU,1,12,QUISPICANCHI - CUSCO,2731,CUSCO,QUISPICANCHI,,5,6,6,SI,2,10,MUNICIPAL PROVINCIAL
1074,10661,PARTIDO FRENTE DE LA ESPERANZA 2021,1,15,PAITA - PIURA,2857,PIURA,PAITA,,5,8,7,SI,3,12,MUNICIPAL PROVINCIAL
1075,14341,PARTIDO POLITICO NACIONAL PERU LIBRE,1,18,HUANCAYO - JUNIN,2218,JUNIN,HUANCAYO,,5,10,8,SI,2,16,MUNICIPAL PROVINCIAL
1076,14354,PARTIDO MORADO,1,18,LAMBAYEQUE - LAMBAYEQUE,2840,LAMBAYEQUE,LAMBAYEQUE,,5,9,9,SI,4,14,MUNICIPAL PROVINCIAL
1077,12401,MOVIMIENTO INDEPENDIENTE FUERZA REGIONAL,1,17,AYABACA - PIURA,1388,PIURA,AYABACA,,5,9,8,SI,5,12,MUNICIPAL PROVINCIAL
1078,14143,CAJAMARCA SIEMPRE VERDE,1,11,CONTUMAZA - CAJAMARCA,1464,CAJAMARCA,CONTUMAZA,,5,6,5,SI,3,8,MUNICIPAL PROVINCIAL
1079,14418,RENOVACION POPULAR,1,10,BELLAVISTA - SAN MARTIN,22,SAN MARTIN,BELLAVISTA,,5,6,4,NO,0,10,MUNICIPAL PROVINCIAL
1080,1025,JUNTOS POR EL PERU,1,12,PADRE ABAD - UCAYALI,1264,UCAYALI,PADRE ABAD,,5,6,6,SI,2,10,MUNICIPAL PROVINCIAL
1081,8028,MOVIMIENTO REGIONAL OBRAS POR LA MODERNIDAD,1,9,PALPA - ICA,2244,ICA,PALPA,,5,5,4,SI,3,6,MUNICIPAL PROVINCIAL
1082,398,PODEMOS PERU,1,11,HUAROCHIRI - LIMA,2731,LIMA,HUAROCHIRI,,5,5,6,SI,1,10,MUNICIPAL PROVINCIAL
1083,14426,PARTIDO POLITICO NACIONAL PERU LIBRE,1,12,QUISPICANCHI - CUSCO,2218,CUSCO,QUISPICANCHI,,5,7,5,SI,2,10,MUNICIPAL PROVINCIAL
1084,14429,MOVIMIENTO REGIONAL WARI LLAQTA,2,16,HUAMANGA - AYACUCHO,2706,AYACUCHO,HUAMANGA,,5,8,8,SI,4,12,MUNICIPAL PROVINCIAL
1085,1052,JUNTOS POR EL PERU,1,7,PURUS - UCAYALI,1264,UCAYALI,PURUS,,5,4,3,SI,1,6,MUNICIPAL PROVINCIAL
1086,14449,PARTIDO MORADO,1,10,PACHITEA - HUANUCO,2840,HUANUCO,PACHITEA,,5,6,4,NO,0,10,MUNICIPAL PROVINCIAL
1087,11325,ALIANZA PARA EL PROGRESO,1,11,CARHUAZ - ANCASH,1257,ANCASH,CARHUAZ,,5,6,5,SI,3,8,MUNICIPAL PROVINCIAL
1088,14431,ACCION POPULAR,1,10,ZARUMILLA - TUMBES,4,TUMBES,ZARUMILLA,,5,5,5,NO,0,10,MUNICIPAL PROVINCIAL
1089,14373,PARTIDO MORADO,1,16,HUANUCO - HUANUCO,2840,HUANUCO,HUANUCO,,5,8,8,SI,2,14,MUNICIPAL PROVINCIAL
1090,3227,JUNTOS POR EL PERU,1,13,LORETO - LORETO,1264,LORETO,LORETO,,5,7,6,SI,3,10,MUNICIPAL PROVINCIAL
1091,14406,PARTIDO DEMOCRATICO SOMOS PERU,1,18,DATEM DEL MARAÑON - LORETO,14,LORETO,DATEM DEL MARAÑON,,5,10,8,SI,8,10,MUNICIPAL PROVINCIAL
1092,7652,ACCION POPULAR,1,10,PICOTA - SAN MARTIN,4,SAN MARTIN,PICOTA,,5,6,4,SI,2,8,MUNICIPAL PROVINCIAL
1093,6161,MOVIMIENTO INDEPENDIENTE REGIONAL HUANUCO PRIMERO,1,23,LEONCIO PRADO - HUANUCO,2162,HUANUCO,LEONCIO PRADO,,5,11,12,SI,11,12,MUNICIPAL PROVINCIAL
1094,14473,ALIANZA PARA EL PROGRESO,1,15,CELENDIN - CAJAMARCA,1257,CAJAMARCA,CELENDIN,,5,8,7,SI,5,10,MUNICIPAL PROVINCIAL
1095,14481,REGION PARA TODOS,1,16,PIURA - PIURA,1411,PIURA,PIURA,,5,9,7,NO,0,16,MUNICIPAL PROVINCIAL
1096,14502,PARTIDO MORADO,1,8,LAURICOCHA - HUANUCO,2840,HUANUCO,LAURICOCHA,,5,4,4,SI,2,6,MUNICIPAL PROVINCIAL
1097,8610,ACCION POPULAR,1,14,ABANCAY - APURIMAC,4,APURIMAC,ABANCAY,,5,7,7,SI,2,12,MUNICIPAL PROVINCIAL
1098,14513,PARTIDO DEMOCRATICO SOMOS PERU,1,6,CAJATAMBO - LIMA,14,LIMA,CAJATAMBO,,5,4,2,NO,0,6,MUNICIPAL PROVINCIAL
1099,1944,CAJAMARCA SIEMPRE VERDE,1,22,CAJAMARCA - CAJAMARCA,1464,CAJAMARCA,CAJAMARCA,,5,12,10,SI,8,14,MUNICIPAL PROVINCIAL
1100,4177,PARTIDO POLITICO NACIONAL PERU LIBRE,1,10,CONTRALMIRANTE VILLAR - TUMBES,2218,TUMBES,CONTRALMIRANTE VILLAR,,5,5,5,SI,4,6,MUNICIPAL PROVINCIAL
1101,6386,FRENTE POPULAR AGRICOLA FIA DEL PERU,1,14,CHANCHAMAYO - JUNIN,2901,JUNIN,CHANCHAMAYO,,5,7,7,SI,2,12,MUNICIPAL PROVINCIAL
1102,14428,MOVIMIENTO POLITICO CAMBIEMOS X HCO,1,16,HUANUCO - HUANUCO,2733,HUANUCO,HUANUCO,,5,8,8,SI,2,14,MUNICIPAL PROVINCIAL
1103,14533,ALIANZA PARA EL PROGRESO,1,13,CONTUMAZA - CAJAMARCA,1257,CAJAMARCA,CONTUMAZA,,5,7,6,SI,5,8,MUNICIPAL PROVINCIAL
1104,14521,ALIANZA PARA EL PROGRESO,1,15,CAJABAMBA - CAJAMARCA,1257,CAJAMARCA,CAJABAMBA,,5,8,7,SI,5,10,MUNICIPAL PROVINCIAL
1105,14556,CAJAMARCA SIEMPRE VERDE,1,10,SAN PABLO - CAJAMARCA,1464,CAJAMARCA,SAN PABLO,,5,6,4,SI,4,6,MUNICIPAL PROVINCIAL
1106,14460,PARTIDO POLITICO NACIONAL PERU LIBRE,1,19,HUANCANE - PUNO,2218,PUNO,HUANCANE,,5,10,9,SI,9,10,MUNICIPAL PROVINCIAL
1107,7581,PARTIDO POLITICO NACIONAL PERU LIBRE,1,9,HUARMEY - ANCASH,2218,ANCASH,HUARMEY,,5,5,4,SI,1,8,MUNICIPAL PROVINCIAL
1108,14504,CAJAMARCA SIEMPRE VERDE,1,12,SAN MARCOS - CAJAMARCA,1464,CAJAMARCA,SAN MARCOS,,5,7,5,SI,2,10,MUNICIPAL PROVINCIAL
1109,14594,RENOVACION POPULAR,1,9,PICOTA - SAN MARTIN,22,SAN MARTIN,PICOTA,,5,5,4,SI,1,8,MUNICIPAL PROVINCIAL
1110,14496,AVANZADA REGIONAL INDEPENDIENTE UNIDOS POR HUANUCO,1,13,AMBO - HUANUCO,2201,HUANUCO,AMBO,,5,7,6,SI,3,10,MUNICIPAL PROVINCIAL
1111,14125,PARTIDO POLITICO NACIONAL PERU LIBRE,1,12,CUTERVO - CAJAMARCA,2218,CAJAMARCA,CUTERVO,,5,7,5,NO,0,12,MUNICIPAL PROVINCIAL
1112,14605,PARTIDO DEMOCRATICO SOMOS PERU,1,9,PUTUMAYO - LORETO,14,LORETO,PUTUMAYO,,5,5,4,SI,3,6,MUNICIPAL PROVINCIAL
1113,5965,CORAZON PATRIOTA,1,18,SATIPO - JUNIN,2729,JUNIN,SATIPO,,5,10,8,SI,6,12,MUNICIPAL PROVINCIAL
1114,12383,MOVIMIENTO INDEPENDIENTE FUERZA REGIONAL,1,13,MORROPON - PIURA,1388,PIURA,MORROPON,,5,7,6,SI,1,12,MUNICIPAL PROVINCIAL
1115,14574,FRENTE REGIONAL TUPAC,1,10,CALCA - CUSCO,2911,CUSCO,CALCA,,5,6,4,NO,0,10,MUNICIPAL PROVINCIAL
1116,14623,ALIANZA PARA EL PROGRESO,1,10,SAN PABLO - CAJAMARCA,1257,CAJAMARCA,SAN PABLO,,5,6,4,SI,4,6,MUNICIPAL PROVINCIAL
1117,5953,FRENTE POPULAR AGRICOLA FIA DEL PERU,1,16,MORROPON - PIURA,2901,PIURA,MORROPON,,5,9,7,SI,4,12,MUNICIPAL PROVINCIAL
1118,4975,ACCION POPULAR,1,14,COTABAMBAS - APURIMAC,4,APURIMAC,COTABAMBAS,,5,8,6,SI,4,10,MUNICIPAL PROVINCIAL
1119,14622,ALIANZA LIBERTAD MADREDIOSENSE,1,9,MANU - MADRE DE DIOS,2809,MADRE DE DIOS,MANU,,5,5,4,SI,3,6,MUNICIPAL PROVINCIAL
1120,14604,MOVIMIENTO POLITICO REGIONAL ENERGIA COMUNAL AMAZONICA,1,12,UTCUBAMBA - AMAZONAS,2229,AMAZONAS,UTCUBAMBA,,5,6,6,NO,0,12,MUNICIPAL PROVINCIAL
1121,14603,ALIANZA PARA EL PROGRESO,1,20,HUALGAYOC - CAJAMARCA,1257,CAJAMARCA,HUALGAYOC,,5,11,9,SI,10,10,MUNICIPAL PROVINCIAL
1122,11598,JUNTOS POR EL DESARROLLO DE AREQUIPA,1,10,CASTILLA - AREQUIPA,2257,AREQUIPA,CASTILLA,,5,5,5,SI,2,8,MUNICIPAL PROVINCIAL
1123,14612,ALIANZA PARA EL PROGRESO,1,21,MOYOBAMBA - SAN MARTIN,1257,SAN MARTIN,MOYOBAMBA,,5,11,10,SI,9,12,MUNICIPAL PROVINCIAL
1124,4999,ACCION POPULAR,1,6,ANTABAMBA - APURIMAC,4,APURIMAC,ANTABAMBA,,5,4,2,NO,0,6,MUNICIPAL PROVINCIAL
1125,11707,JUNTOS POR EL DESARROLLO DE AREQUIPA,1,11,CARAVELI - AREQUIPA,2257,AREQUIPA,CARAVELI,,5,6,5,SI,3,8,MUNICIPAL PROVINCIAL
1126,3151,JUNTOS POR EL PERU,1,16,MAYNAS - LORETO,1264,LORETO,MAYNAS,,5,9,7,NO,0,16,MUNICIPAL PROVINCIAL
1127,14498,GESTIONANDO OBRAS Y OPORTUNIDADES CON LIDERAZGO,1,19,SAN ROMAN - PUNO,2667,PUNO,SAN ROMAN,,5,10,9,SI,5,14,MUNICIPAL PROVINCIAL
1128,14569,PIURA RENACE,1,17,SULLANA - PIURA,2876,PIURA,SULLANA,,5,9,8,SI,3,14,MUNICIPAL PROVINCIAL
1129,9605,PARTIDO DEMOCRATICO SOMOS PERU,1,16,TACNA - TACNA,14,TACNA,TACNA,,5,9,7,SI,2,14,MUNICIPAL PROVINCIAL
1130,14664,ALIANZA PARA EL PROGRESO,1,10,EL DORADO - SAN MARTIN,1257,SAN MARTIN,EL DORADO,,5,6,4,SI,2,8,MUNICIPAL PROVINCIAL
1131,14638,PASCO DIGNIDAD,1,17,PASCO - PASCO,1705,PASCO,PASCO,,5,8,9,SI,5,12,MUNICIPAL PROVINCIAL
1132,7828,PARTIDO FRENTE DE LA ESPERANZA 2021,1,16,MAYNAS - LORETO,2857,LORETO,MAYNAS,,5,9,7,NO,0,16,MUNICIPAL PROVINCIAL
1133,10837,FUERZA LORETANA,1,12,ALTO AMAZONAS - LORETO,61,LORETO,ALTO AMAZONAS,,5,6,6,NO,0,12,MUNICIPAL PROVINCIAL
1134,14644,PARTIDO DEMOCRATICO SOMOS PERU,1,10,JULCAN - LA LIBERTAD,14,LA LIBERTAD,JULCAN,,5,6,4,SI,2,8,MUNICIPAL PROVINCIAL
1135,5515,CORAZON PATRIOTA,1,12,YAULI - JUNIN,2729,JUNIN,YAULI,,5,6,6,SI,4,8,MUNICIPAL PROVINCIAL
1136,2966,MOVIMIENTO REGIONAL AREQUIPA AVANCEMOS,1,14,CAMANA - AREQUIPA,2307,AREQUIPA,CAMANA,,5,8,6,SI,4,10,MUNICIPAL PROVINCIAL
1137,14666,AVANZA PAIS - PARTIDO DE INTEGRACION SOCIAL,1,11,YAUYOS - LIMA,2173,LIMA,YAUYOS,,5,6,5,SI,5,6,MUNICIPAL PROVINCIAL
1138,14668,JUNTOS POR EL DESARROLLO DE AREQUIPA,1,14,CAMANA - AREQUIPA,2257,AREQUIPA,CAMANA,,5,6,8,SI,4,10,MUNICIPAL PROVINCIAL
1139,14691,ALIANZA PARA EL PROGRESO,1,12,PICOTA - SAN MARTIN,1257,SAN MARTIN,PICOTA,,5,7,5,SI,4,8,MUNICIPAL PROVINCIAL
1140,2106,ACCION POPULAR,1,8,PARURO - CUSCO,4,CUSCO,PARURO,,5,4,4,NO,0,8,MUNICIPAL PROVINCIAL
1141,12796,MORAL Y DESARROLLO,1,10,SANDIA - PUNO,292,PUNO,SANDIA,,5,6,4,NO,0,10,MUNICIPAL PROVINCIAL
1142,14224,PODER ANDINO,1,23,AZANGARO - PUNO,2338,PUNO,AZANGARO,,5,12,11,SI,11,12,MUNICIPAL PROVINCIAL
1143,5758,CORAZON PATRIOTA,1,14,CHUPACA - JUNIN,2729,JUNIN,CHUPACA,,5,8,6,SI,4,10,MUNICIPAL PROVINCIAL
1144,14703,ALIANZA PARA EL PROGRESO,1,18,CHOTA - CAJAMARCA,1257,CAJAMARCA,CHOTA,,5,10,8,SI,6,12,MUNICIPAL PROVINCIAL
1145,14684,FRENTE REGIONAL DE CAJAMARCA,1,17,CUTERVO - CAJAMARCA,160,CAJAMARCA,CUTERVO,,5,9,8,SI,5,12,MUNICIPAL PROVINCIAL
1146,4272,ACCION POPULAR,1,14,HUAMANGA - AYACUCHO,4,AYACUCHO,HUAMANGA,,5,7,7,SI,2,12,MUNICIPAL PROVINCIAL
1147,14720,ALIANZA PARA EL PROGRESO,1,22,RIOJA - SAN MARTIN,1257,SAN MARTIN,RIOJA,,5,12,10,SI,10,12,MUNICIPAL PROVINCIAL
1148,12371,MOVIMIENTO INDEPENDIENTE FUERZA REGIONAL,1,15,HUANCABAMBA - PIURA,1388,PIURA,HUANCABAMBA,,5,8,7,SI,3,12,MUNICIPAL PROVINCIAL
1149,14445,MOVIMIENTO REGIONAL DEL AJO AREQUIPA CON JUSTICIA Y ORDEN,1,10,ISLAY - AREQUIPA,2920,AREQUIPA,ISLAY,,5,5,5,NO,0,10,MUNICIPAL PROVINCIAL
1150,14727,MOVIMIENTO REGIONAL EL MAICITO,1,15,HUARAZ - ANCASH,2245,ANCASH,HUARAZ,,5,8,7,SI,3,12,MUNICIPAL PROVINCIAL
1151,4604,JUNTOS POR EL PERU,1,14,LAMBAYEQUE - LAMBAYEQUE,1264,LAMBAYEQUE,LAMBAYEQUE,,5,8,6,NO,0,14,MUNICIPAL PROVINCIAL
1152,14716,ALIANZA PARA EL PROGRESO,1,12,YUNGAY - ANCASH,1257,ANCASH,YUNGAY,,5,7,5,SI,2,10,MUNICIPAL PROVINCIAL
1153,8083,CORAZON PATRIOTA,1,17,CHANCHAMAYO - JUNIN,2729,JUNIN,CHANCHAMAYO,,5,9,8,SI,5,12,MUNICIPAL PROVINCIAL
1154,14387,SENTIMIENTO AMAZONENSE REGIONAL,1,14,UTCUBAMBA - AMAZONAS,2277,AMAZONAS,UTCUBAMBA,,5,7,7,SI,2,12,MUNICIPAL PROVINCIAL
1155,14699,AUTOGOBIERNO AYLLU,1,11,CALCA - CUSCO,153,CUSCO,CALCA,,5,5,6,SI,1,10,MUNICIPAL PROVINCIAL
1156,4429,JUNTOS POR EL PERU,1,10,ZARUMILLA - TUMBES,1264,TUMBES,ZARUMILLA,,5,5,5,NO,0,10,MUNICIPAL PROVINCIAL
1157,14717,AREQUIPA RENACE,1,13,CARAVELI - AREQUIPA,443,AREQUIPA,CARAVELI,,5,7,6,SI,5,8,MUNICIPAL PROVINCIAL
1158,12103,RENOVACION POPULAR,1,8,YAULI - JUNIN,22,JUNIN,YAULI,,5,5,3,NO,0,8,MUNICIPAL PROVINCIAL
1159,14749,ALIANZA PARA EL PROGRESO,1,20,CUTERVO - CAJAMARCA,1257,CAJAMARCA,CUTERVO,,5,11,9,SI,8,12,MUNICIPAL PROVINCIAL
1160,4422,JUNTOS POR EL PERU,1,12,TUMBES - TUMBES,1264,TUMBES,TUMBES,,5,7,5,NO,0,12,MUNICIPAL PROVINCIAL
1161,8786,CONCERTACION PARA EL DESARROLLO REGIONAL - LIMA,1,14,HUAROCHIRI - LIMA,332,LIMA,HUAROCHIRI,,5,7,7,SI,4,10,MUNICIPAL PROVINCIAL
1162,12260,PARTIDO FRENTE DE LA ESPERANZA 2021,1,6,GRAU - APURIMAC,2857,APURIMAC,GRAU,,5,4,2,NO,0,6,MUNICIPAL PROVINCIAL
1163,14661,ALIANZA POR NUESTRO DESARROLLO,1,17,LA MAR - AYACUCHO,2710,AYACUCHO,LA MAR,,5,9,8,SI,7,10,MUNICIPAL PROVINCIAL
1164,14765,ALIANZA PARA EL PROGRESO,1,17,BARRANCA - LIMA,1257,LIMA,BARRANCA,,5,9,8,SI,5,12,MUNICIPAL PROVINCIAL
1165,10909,MORAL Y DESARROLLO,1,12,LAMPA - PUNO,292,PUNO,LAMPA,,5,6,6,SI,4,8,MUNICIPAL PROVINCIAL
1166,12026,PARTIDO FRENTE DE LA ESPERANZA 2021,1,18,CALCA - CUSCO,2857,CUSCO,CALCA,,5,10,8,SI,8,10,MUNICIPAL PROVINCIAL
1167,5771,FRENTE POPULAR AGRICOLA FIA DEL PERU,1,10,ZARUMILLA - TUMBES,2901,TUMBES,ZARUMILLA,,5,5,5,NO,0,10,MUNICIPAL PROVINCIAL
1168,14711,RENOVACION POPULAR,1,24,AREQUIPA - AREQUIPA,22,AREQUIPA,AREQUIPA,,5,13,11,SI,8,16,MUNICIPAL PROVINCIAL
1169,14633,AUTOGOBIERNO AYLLU,1,17,CUSCO - CUSCO,153,CUSCO,CUSCO,,5,8,9,SI,3,14,MUNICIPAL PROVINCIAL
1170,14779,PODEMOS PERU,1,16,CHINCHA - ICA,2731,ICA,CHINCHA,,5,9,7,SI,4,12,MUNICIPAL PROVINCIAL
1171,12408,MOVIMIENTO INDEPENDIENTE FUERZA REGIONAL,1,12,PAITA - PIURA,1388,PIURA,PAITA,,5,6,6,NO,0,12,MUNICIPAL PROVINCIAL
1172,14780,FRENTE REGIONAL TUPAC,1,14,CANCHIS - CUSCO,2911,CUSCO,CANCHIS,,5,8,6,SI,2,12,MUNICIPAL PROVINCIAL
1173,14048,MOVIMIENTO ACCION NACIONALISTA PERUANO,1,10,HUARMEY - ANCASH,360,ANCASH,HUARMEY,,5,6,4,SI,2,8,MUNICIPAL PROVINCIAL
1174,7904,PARTIDO FRENTE DE LA ESPERANZA 2021,1,14,MARISCAL RAMON CASTILLA - LORETO,2857,LORETO,MARISCAL RAMON CASTILLA,,5,7,7,SI,4,10,MUNICIPAL PROVINCIAL
1175,2647,JUNTOS POR EL PERU,1,12,CHINCHA - ICA,1264,ICA,CHINCHA,,5,6,6,NO,0,12,MUNICIPAL PROVINCIAL
1176,12972,CONCERTACION PARA EL DESARROLLO REGIONAL - LIMA,1,6,YAUYOS - LIMA,332,LIMA,YAUYOS,,5,4,2,NO,0,6,MUNICIPAL PROVINCIAL
1177,5046,JUNTOS POR EL PERU,1,11,MARISCAL NIETO - MOQUEGUA,1264,MOQUEGUA,MARISCAL NIETO,,5,6,5,SI,1,10,MUNICIPAL PROVINCIAL
1178,13175,MOVIMIENTO RESISTENCIA AMAZONICA,1,10,LORETO - LORETO,2691,LORETO,LORETO,,5,6,4,NO,0,10,MUNICIPAL PROVINCIAL
1179,2538,PARTIDO FRENTE DE LA ESPERANZA 2021,1,16,BARRANCA - LIMA,2857,LIMA,BARRANCA,,5,8,8,SI,4,12,MUNICIPAL PROVINCIAL
1180,5838,FUERZA POPULAR,1,19,CHICLAYO - LAMBAYEQUE,1366,LAMBAYEQUE,CHICLAYO,,5,10,9,SI,3,16,MUNICIPAL PROVINCIAL
1181,10469,AVANZA PAIS - PARTIDO DE INTEGRACION SOCIAL,1,21,HUARAZ - ANCASH,2173,ANCASH,HUARAZ,,5,11,10,SI,9,12,MUNICIPAL PROVINCIAL
1182,7059,FRENTE ESPERANZA POR TACNA,1,8,TARATA - TACNA,2708,TACNA,TARATA,,5,4,4,SI,2,6,MUNICIPAL PROVINCIAL
1183,13356,PARTIDO DEMOCRATICO SOMOS PERU,1,15,SECHURA - PIURA,14,PIURA,SECHURA,,5,8,7,SI,5,10,MUNICIPAL PROVINCIAL
1184,10371,SENTIMIENTO AMAZONENSE REGIONAL,1,9,RODRIGUEZ DE MENDOZA - AMAZONAS,2277,AMAZONAS,RODRIGUEZ DE MENDOZA,,5,5,4,SI,1,8,MUNICIPAL PROVINCIAL
1185,14796,PARTIDO DEMOCRATICO SOMOS PERU,1,14,MARISCAL RAMON CASTILLA - LORETO,14,LORETO,MARISCAL RAMON CASTILLA,,5,8,6,SI,4,10,MUNICIPAL PROVINCIAL
1186,6349,JUNTOS POR EL PERU,1,12,MOYOBAMBA - SAN MARTIN,1264,SAN MARTIN,MOYOBAMBA,,5,7,5,NO,0,12,MUNICIPAL PROVINCIAL
1187,5885,FUERZA POPULAR,1,12,FERREÑAFE - LAMBAYEQUE,1366,LAMBAYEQUE,FERREÑAFE,,5,6,6,NO,0,12,MUNICIPAL PROVINCIAL
1188,13232,ACCION POPULAR,1,6,TAHUAMANU - MADRE DE DIOS,4,MADRE DE DIOS,TAHUAMANU,,5,4,2,NO,0,6,MUNICIPAL PROVINCIAL
1189,6187,FUERZA POPULAR,1,15,LAMBAYEQUE - LAMBAYEQUE,1366,LAMBAYEQUE,LAMBAYEQUE,,5,8,7,SI,1,14,MUNICIPAL PROVINCIAL
1190,14255,AVANZA PAIS - PARTIDO DE INTEGRACION SOCIAL,1,17,CHICLAYO - LAMBAYEQUE,2173,LAMBAYEQUE,CHICLAYO,,5,9,8,SI,1,16,MUNICIPAL PROVINCIAL
1191,852,PARTIDO FRENTE DE LA ESPERANZA 2021,1,17,CALLAO - CALLAO,2857,CALLAO,CALLAO,,5,8,9,SI,1,16,MUNICIPAL PROVINCIAL
1192,14856,ALIANZA PARA EL PROGRESO,1,15,CAÑETE - LIMA,1257,LIMA,CAÑETE,,5,7,8,SI,3,12,MUNICIPAL PROVINCIAL
1193,14777,MOVIMIENTO INDEPENDIENTE REGIONAL: MOVIMIENTO AMPLIO Y  SOLIDARIO: SOMOS MAS,1,18,ILO - MOQUEGUA,2916,MOQUEGUA,ILO,,5,9,9,SI,8,10,MUNICIPAL PROVINCIAL
1194,12019,PARTIDO FRENTE DE LA ESPERANZA 2021,1,9,AYMARAES - APURIMAC,2857,APURIMAC,AYMARAES,,5,5,4,SI,1,8,MUNICIPAL PROVINCIAL
1195,18,PODEMOS PERU,1,14,HUARI - ANCASH,2731,ANCASH,HUARI,,5,7,7,SI,4,10,MUNICIPAL PROVINCIAL
1196,14858,ALIANZA PARA EL PROGRESO,1,10,BOLOGNESI - ANCASH,1257,ANCASH,BOLOGNESI,,5,5,5,SI,4,6,MUNICIPAL PROVINCIAL
1197,12798,AVANZA PAIS - PARTIDO DE INTEGRACION SOCIAL,1,8,OYON - LIMA,2173,LIMA,OYON,,5,4,4,SI,2,6,MUNICIPAL PROVINCIAL
1198,14826,ALIANZA PARA EL PROGRESO,1,21,CAJAMARCA - CAJAMARCA,1257,CAJAMARCA,CAJAMARCA,,5,11,10,SI,7,14,MUNICIPAL PROVINCIAL
1199,14848,PARTIDO DEMOCRATICO SOMOS PERU,1,14,LORETO - LORETO,14,LORETO,LORETO,,5,8,6,SI,4,10,MUNICIPAL PROVINCIAL
1200,793,PARTIDO FRENTE DE LA ESPERANZA 2021,1,16,CHICLAYO - LAMBAYEQUE,2857,LAMBAYEQUE,CHICLAYO,,5,8,8,NO,0,16,MUNICIPAL PROVINCIAL
1201,2385,PARTIDO FRENTE DE LA ESPERANZA 2021,1,15,CAÑETE - LIMA,2857,LIMA,CAÑETE,,5,8,7,SI,3,12,MUNICIPAL PROVINCIAL
1202,14881,MOVIMIENTO DE INTEGRACION Y REVOLUCION ANDINA,1,14,AZANGARO - PUNO,2702,PUNO,AZANGARO,,5,8,6,SI,2,12,MUNICIPAL PROVINCIAL
1203,2425,PODEMOS PERU,1,18,SECHURA - PIURA,2731,PIURA,SECHURA,,5,9,9,SI,8,10,MUNICIPAL PROVINCIAL
1204,14357,CONCERTACION PARA EL DESARROLLO REGIONAL - LIMA,1,8,OYON - LIMA,332,LIMA,OYON,,5,5,3,SI,2,6,MUNICIPAL PROVINCIAL
1205,11188,FRENTE AMPLIO PARA EL DESARROLLO DEL PUEBLO,1,14,HUANCANE - PUNO,1670,PUNO,HUANCANE,,5,8,6,SI,4,10,MUNICIPAL PROVINCIAL
1206,14846,PARTIDO DEMOCRATICO SOMOS PERU,1,13,ANTA - CUSCO,14,CUSCO,ANTA,,5,7,6,SI,3,10,MUNICIPAL PROVINCIAL
1207,13262,POR LAS COMUNIDADES FUENTE DE INTEGRACION ANDINA DE PUNO - CONFIA - PUNO,1,10,MOHO - PUNO,2230,PUNO,MOHO,,5,6,4,SI,4,6,MUNICIPAL PROVINCIAL
1208,14769,MOVIMIENTO RESISTENCIA AMAZONICA,2,10,LORETO - LORETO,2691,LORETO,LORETO,,5,6,4,NO,0,10,MUNICIPAL PROVINCIAL
1209,1412,JUNTOS POR EL PERU,1,18,CHICLAYO - LAMBAYEQUE,1264,LAMBAYEQUE,CHICLAYO,,5,9,9,SI,2,16,MUNICIPAL PROVINCIAL
1210,2893,FRENTE ESPERANZA POR TACNA,1,9,JORGE BASADRE - TACNA,2708,TACNA,JORGE BASADRE,,5,4,5,SI,3,6,MUNICIPAL PROVINCIAL
1211,14629,MOVIMIENTO REGIONAL EL MAICITO,1,15,HUARI - ANCASH,2245,ANCASH,HUARI,,5,8,7,SI,5,10,MUNICIPAL PROVINCIAL
1212,14907,ALIANZA PARA EL PROGRESO,1,8,RECUAY - ANCASH,1257,ANCASH,RECUAY,,5,4,4,SI,2,6,MUNICIPAL PROVINCIAL
1213,14933,ALIANZA PARA EL PROGRESO,1,15,HUAURA - LIMA,1257,LIMA,HUAURA,,5,7,8,SI,3,12,MUNICIPAL PROVINCIAL
1214,14925,CAJAMARCA SIEMPRE VERDE,1,12,CELENDIN - CAJAMARCA,1464,CAJAMARCA,CELENDIN,,5,7,5,SI,2,10,MUNICIPAL PROVINCIAL
1215,4412,FUERZA POPULAR,1,11,ISLAY - AREQUIPA,1366,AREQUIPA,ISLAY,,5,5,6,SI,1,10,MUNICIPAL PROVINCIAL
1216,14863,ALIANZA POR NUESTRO DESARROLLO,1,12,SUCRE - AYACUCHO,2710,AYACUCHO,SUCRE,,5,7,5,SI,6,6,MUNICIPAL PROVINCIAL
1217,14901,FRENTE REGIONAL TUPAC,1,13,LA CONVENCION - CUSCO,2911,CUSCO,LA CONVENCION,,5,7,6,SI,1,12,MUNICIPAL PROVINCIAL
1218,2865,MOVIMIENTO REGIONAL AYNI,1,19,TAYACAJA - HUANCAVELICA,136,HUANCAVELICA,TAYACAJA,,5,10,9,SI,9,10,MUNICIPAL PROVINCIAL
1219,8826,CORAZON PATRIOTA,1,18,JAUJA - JUNIN,2729,JUNIN,JAUJA,,5,10,8,SI,8,10,MUNICIPAL PROVINCIAL
1220,7752,FUERZA POPULAR,1,10,HUAYLAS - ANCASH,1366,ANCASH,HUAYLAS,,5,5,5,NO,0,10,MUNICIPAL PROVINCIAL
1221,14956,ALIANZA PARA EL PROGRESO,1,14,HUARAL - LIMA,1257,LIMA,HUARAL,,5,7,7,SI,2,12,MUNICIPAL PROVINCIAL
1222,7774,FUERZA POPULAR,1,10,HUARMEY - ANCASH,1366,ANCASH,HUARMEY,,5,6,4,SI,2,8,MUNICIPAL PROVINCIAL
1223,14884,NUEVA LIBERTAD,1,12,PACASMAYO - LA LIBERTAD,2232,LA LIBERTAD,PACASMAYO,,5,7,5,NO,0,12,MUNICIPAL PROVINCIAL
1224,7787,FUERZA POPULAR,1,12,HUARAZ - ANCASH,1366,ANCASH,HUARAZ,,5,5,7,NO,0,12,MUNICIPAL PROVINCIAL
1225,5379,ALIANZA GOBIERNO UNIDAD Y ACCION,1,25,SANTA - ANCASH,2856,ANCASH,SANTA,,5,13,12,SI,11,14,MUNICIPAL PROVINCIAL
1226,7797,FUERZA POPULAR,2,12,HUARAZ - ANCASH,1366,ANCASH,HUARAZ,,5,7,5,NO,0,12,MUNICIPAL PROVINCIAL
1227,12993,RENOVACION POPULAR,1,10,CHUPACA - JUNIN,22,JUNIN,CHUPACA,,5,6,4,NO,0,10,MUNICIPAL PROVINCIAL
1228,7803,FUERZA POPULAR,1,10,CASMA - ANCASH,1366,ANCASH,CASMA,,5,5,5,NO,0,10,MUNICIPAL PROVINCIAL
1229,3901,FUERZA POPULAR,1,12,PISCO - ICA,1366,ICA,PISCO,,5,7,5,NO,0,12,MUNICIPAL PROVINCIAL
1230,14943,ALIANZA PARA EL PROGRESO,1,18,SAN IGNACIO - CAJAMARCA,1257,CAJAMARCA,SAN IGNACIO,,5,9,9,SI,6,12,MUNICIPAL PROVINCIAL
1231,7848,FUERZA POPULAR,1,14,SANTA - ANCASH,1366,ANCASH,SANTA,,5,7,7,NO,0,14,MUNICIPAL PROVINCIAL
1232,14451,RENOVACION POPULAR,1,10,TOCACHE - SAN MARTIN,22,SAN MARTIN,TOCACHE,,5,6,4,NO,0,10,MUNICIPAL PROVINCIAL
1233,14978,ALIANZA PARA EL PROGRESO,1,11,HUAROCHIRI - LIMA,1257,LIMA,HUAROCHIRI,,5,6,5,SI,1,10,MUNICIPAL PROVINCIAL
1234,14958,JUNIN SOSTENIBLE CON SU GENTE,1,14,TARMA - JUNIN,303,JUNIN,TARMA,,5,6,8,SI,4,10,MUNICIPAL PROVINCIAL
1235,14955,FRENTE POPULAR AGRICOLA FIA DEL PERU,1,10,GRAN CHIMU - LA LIBERTAD,2901,LA LIBERTAD,GRAN CHIMU,,5,5,5,SI,2,8,MUNICIPAL PROVINCIAL
1236,14899,AVANZA PAIS - PARTIDO DE INTEGRACION SOCIAL,1,12,HUAROCHIRI - LIMA,2173,LIMA,HUAROCHIRI,,5,6,6,SI,2,10,MUNICIPAL PROVINCIAL
1237,14906,MOVIMENTO INDEPENDIENTE REGIONAL FUERZA TACNA,1,14,TACNA - TACNA,2432,TACNA,TACNA,,5,8,6,NO,0,14,MUNICIPAL PROVINCIAL
1238,11900,JUNTOS POR EL DESARROLLO DE AREQUIPA,1,22,AREQUIPA - AREQUIPA,2257,AREQUIPA,AREQUIPA,,5,11,11,SI,6,16,MUNICIPAL PROVINCIAL
1239,12608,SOMOS PUEBLO,1,15,SAN ANTONIO DE PUTINA - PUNO,2657,PUNO,SAN ANTONIO DE PUTINA,,5,8,7,SI,7,8,MUNICIPAL PROVINCIAL
1240,14961,PARTIDO MORADO,1,16,CALLAO - CALLAO,2840,CALLAO,CALLAO,,5,9,7,NO,0,16,MUNICIPAL PROVINCIAL
1241,11516,SUMATE,1,11,OTUZCO - LA LIBERTAD,67,LA LIBERTAD,OTUZCO,,5,6,5,SI,1,10,MUNICIPAL PROVINCIAL
1242,9101,RENOVACION POPULAR,1,13,SAN MARTIN - SAN MARTIN,22,SAN MARTIN,SAN MARTIN,,5,6,7,SI,1,12,MUNICIPAL PROVINCIAL
1243,4204,PODEMOS PERU,1,16,PUNO - PUNO,2731,PUNO,PUNO,,5,8,8,SI,4,12,MUNICIPAL PROVINCIAL
1244,5181,JUNTOS POR EL PERU,1,13,BAGUA - AMAZONAS,1264,AMAZONAS,BAGUA,,5,7,6,SI,3,10,MUNICIPAL PROVINCIAL
1245,7940,PARTIDO FRENTE DE LA ESPERANZA 2021,1,10,REQUENA - LORETO,2857,LORETO,REQUENA,,5,6,4,NO,0,10,MUNICIPAL PROVINCIAL
1246,14962,MOVIMIENTO REGIONAL FORTALEZA PERU,1,18,TRUJILLO - LA LIBERTAD,2738,LA LIBERTAD,TRUJILLO,,5,9,9,SI,2,16,MUNICIPAL PROVINCIAL
1247,15009,ALIANZA PARA EL PROGRESO,1,19,JAEN - CAJAMARCA,1257,CAJAMARCA,JAEN,,5,10,9,SI,7,12,MUNICIPAL PROVINCIAL
1248,9168,POR LAS COMUNIDADES FUENTE DE INTEGRACION ANDINA DE PUNO - CONFIA - PUNO,1,14,YUNGUYO - PUNO,2230,PUNO,YUNGUYO,,5,8,6,SI,6,8,MUNICIPAL PROVINCIAL
1249,14993,MOVIMIENTO DE INTEGRACION Y REVOLUCION ANDINA,1,17,SAN ROMAN - PUNO,2702,PUNO,SAN ROMAN,,5,9,8,SI,3,14,MUNICIPAL PROVINCIAL
1250,266,PODEMOS PERU,1,12,PASCO - PASCO,2731,PASCO,PASCO,,5,7,5,NO,0,12,MUNICIPAL PROVINCIAL
1251,14820,AUTOGOBIERNO AYLLU,1,10,ANTA - CUSCO,153,CUSCO,ANTA,,5,5,5,NO,0,10,MUNICIPAL PROVINCIAL
1252,4618,FRENTE ESPERANZA POR TACNA,5,10,CANDARAVE - TACNA,2708,TACNA,CANDARAVE,,5,6,4,SI,4,6,MUNICIPAL PROVINCIAL
1253,15006,MOVIMIENTO INDEPENDIENTE REGIONAL MI BUEN VECINO,1,12,AMBO - HUANUCO,2730,HUANUCO,AMBO,,5,7,5,SI,2,10,MUNICIPAL PROVINCIAL
1254,15023,SOMOS PUEBLO,1,13,HUANCANE - PUNO,2657,PUNO,HUANCANE,,5,7,6,SI,3,10,MUNICIPAL PROVINCIAL
1255,15047,ALIANZA PARA EL PROGRESO,1,22,ABANCAY - APURIMAC,1257,APURIMAC,ABANCAY,,5,12,10,SI,10,12,MUNICIPAL PROVINCIAL
1256,5510,"PARA LA TRANSFORMACION, INTEGRACION Y ALIANZA-PATRIA",1,7,CANDARAVE - TACNA,2904,TACNA,CANDARAVE,,5,4,3,SI,1,6,MUNICIPAL PROVINCIAL
1257,8023,HATARIY APURIMAC,1,12,COTABAMBAS - APURIMAC,2886,APURIMAC,COTABAMBAS,,5,7,5,SI,2,10,MUNICIPAL PROVINCIAL
1258,15000,ALIANZA PARA EL PROGRESO,1,10,YAUYOS - LIMA,1257,LIMA,YAUYOS,,5,5,5,SI,4,6,MUNICIPAL PROVINCIAL
1259,15035,ACCION POPULAR,1,17,CHICLAYO - LAMBAYEQUE,4,LAMBAYEQUE,CHICLAYO,,5,9,8,SI,1,16,MUNICIPAL PROVINCIAL
1260,12222,REGION PARA TODOS,1,15,PAITA - PIURA,1411,PIURA,PAITA,,5,8,7,SI,3,12,MUNICIPAL PROVINCIAL
1261,15002,MOVIMIENTO REGIONAL EL MAICITO,1,14,HUAYLAS - ANCASH,2245,ANCASH,HUAYLAS,,5,8,6,SI,4,10,MUNICIPAL PROVINCIAL
1262,15013,JUNIN SOSTENIBLE CON SU GENTE,1,13,CHANCHAMAYO - JUNIN,303,JUNIN,CHANCHAMAYO,,5,7,6,SI,1,12,MUNICIPAL PROVINCIAL
1263,5398,CORAZON PATRIOTA,1,17,TARMA - JUNIN,2729,JUNIN,TARMA,,5,8,9,SI,7,10,MUNICIPAL PROVINCIAL
1264,15020,PARTIDO DEMOCRATICO SOMOS PERU,1,15,UCAYALI - LORETO,14,LORETO,UCAYALI,,5,8,7,SI,5,10,MUNICIPAL PROVINCIAL
1265,12857,PROGRESISTA DE APURIMAC,1,8,CHINCHEROS - APURIMAC,2737,APURIMAC,CHINCHEROS,,5,4,4,NO,0,8,MUNICIPAL PROVINCIAL
1266,5527,FUERZA POPULAR,1,12,CHOTA - CAJAMARCA,1366,CAJAMARCA,CHOTA,,5,6,6,NO,0,12,MUNICIPAL PROVINCIAL
1267,15082,ALIANZA PARA EL PROGRESO,1,22,CALLAO - CALLAO,1257,CALLAO,CALLAO,,5,11,11,SI,6,16,MUNICIPAL PROVINCIAL
1268,5452,FUERZA POPULAR,1,14,CAJAMARCA - CAJAMARCA,1366,CAJAMARCA,CAJAMARCA,,5,7,7,NO,0,14,MUNICIPAL PROVINCIAL
1269,14667,PARTIDO DEMOCRATICO SOMOS PERU,1,13,JAEN - CAJAMARCA,14,CAJAMARCA,JAEN,,5,7,6,SI,1,12,MUNICIPAL PROVINCIAL
1270,9783,PARTIDO FRENTE DE LA ESPERANZA 2021,1,18,PIURA - PIURA,2857,PIURA,PIURA,,5,10,8,SI,2,16,MUNICIPAL PROVINCIAL
1271,8024,PARTIDO FRENTE DE LA ESPERANZA 2021,1,26,SAN ROMAN - PUNO,2857,PUNO,SAN ROMAN,,5,14,12,SI,12,14,MUNICIPAL PROVINCIAL
1272,1833,JUNTOS POR EL PERU,1,8,CANTA - LIMA,1264,LIMA,CANTA,,5,5,3,SI,2,6,MUNICIPAL PROVINCIAL
1273,12649,PARTIDO DEMOCRATICO SOMOS PERU,1,16,PAITA - PIURA,14,PIURA,PAITA,,5,9,7,SI,4,12,MUNICIPAL PROVINCIAL
1274,6765,JUNTOS POR EL PERU,1,17,HUANCAYO - JUNIN,1264,JUNIN,HUANCAYO,,5,9,8,SI,1,16,MUNICIPAL PROVINCIAL
1275,15067,PODEMOS PERU,1,11,EL COLLAO - PUNO,2731,PUNO,EL COLLAO,,5,6,5,SI,1,10,MUNICIPAL PROVINCIAL
1276,12969,MOVIMIENTO INDEPENDIENTE REIVINDIQUEMOS LORETO,1,24,MAYNAS - LORETO,2874,LORETO,MAYNAS,,5,12,12,SI,8,16,MUNICIPAL PROVINCIAL
1277,15081,ALIANZA PARA EL PROGRESO,1,12,SANTA CRUZ - CAJAMARCA,1257,CAJAMARCA,SANTA CRUZ,,5,7,5,SI,4,8,MUNICIPAL PROVINCIAL
1278,2756,PARTIDO FRENTE DE LA ESPERANZA 2021,1,14,HUAYLAS - ANCASH,2857,ANCASH,HUAYLAS,,5,8,6,SI,4,10,MUNICIPAL PROVINCIAL
1279,8078,PARTIDO FRENTE DE LA ESPERANZA 2021,1,21,TRUJILLO - LA LIBERTAD,2857,LA LIBERTAD,TRUJILLO,,5,11,10,SI,5,16,MUNICIPAL PROVINCIAL
1280,6207,FUERZA POPULAR,1,14,ICA - ICA,1366,ICA,ICA,,5,7,7,NO,0,14,MUNICIPAL PROVINCIAL
1281,5299,FUERZA POPULAR,1,15,SULLANA - PIURA,1366,PIURA,SULLANA,,5,7,8,SI,1,14,MUNICIPAL PROVINCIAL
1282,5295,FUERZA POPULAR,1,12,TALARA - PIURA,1366,PIURA,TALARA,,5,5,7,NO,0,12,MUNICIPAL PROVINCIAL
1283,5290,FUERZA POPULAR,1,12,MORROPON - PIURA,1366,PIURA,MORROPON,,5,7,5,NO,0,12,MUNICIPAL PROVINCIAL
1284,14320,POR LAS COMUNIDADES FUENTE DE INTEGRACION ANDINA DE PUNO - CONFIA - PUNO,1,12,SANDIA - PUNO,2230,PUNO,SANDIA,,5,7,5,SI,2,10,MUNICIPAL PROVINCIAL
1285,14305,PARTIDO FRENTE DE LA ESPERANZA 2021,1,8,PARURO - CUSCO,2857,CUSCO,PARURO,,5,5,3,NO,0,8,MUNICIPAL PROVINCIAL
1286,5284,FUERZA POPULAR,1,16,PIURA - PIURA,1366,PIURA,PIURA,,5,9,7,NO,0,16,MUNICIPAL PROVINCIAL
1287,2850,PARTIDO FRENTE DE LA ESPERANZA 2021,1,18,CORONEL PORTILLO - UCAYALI,2857,UCAYALI,CORONEL PORTILLO,,5,10,8,SI,4,14,MUNICIPAL PROVINCIAL
1288,15065,NUEVA LIBERTAD,1,10,VIRU - LA LIBERTAD,2232,LA LIBERTAD,VIRU,,5,5,5,NO,0,10,MUNICIPAL PROVINCIAL
1289,11170,MOVIMIENTO REGIONAL INKA PACHAKUTEQ,1,13,PARURO - CUSCO,2368,CUSCO,PARURO,,5,7,6,SI,5,8,MUNICIPAL PROVINCIAL
1290,14411,REFORMA Y HONRADEZ POR MAS OBRAS,1,12,MOHO - PUNO,2912,PUNO,MOHO,,5,7,5,SI,6,6,MUNICIPAL PROVINCIAL
1291,15113,PARTIDO POLITICO NACIONAL PERU LIBRE,1,8,JUNIN - JUNIN,2218,JUNIN,JUNIN,,5,4,4,SI,2,6,MUNICIPAL PROVINCIAL
1292,5107,FUERZA POPULAR,1,12,TUMBES - TUMBES,1366,TUMBES,TUMBES,,5,6,6,NO,0,12,MUNICIPAL PROVINCIAL
1293,13715,PARTIDO MORADO,1,6,CANDARAVE - TACNA,2840,TACNA,CANDARAVE,,5,2,4,NO,0,6,MUNICIPAL PROVINCIAL
1294,14900,FRENTE REGIONAL DE CAJAMARCA,1,17,SAN MIGUEL - CAJAMARCA,160,CAJAMARCA,SAN MIGUEL,,5,9,8,SI,9,8,MUNICIPAL PROVINCIAL
1295,5052,FUERZA POPULAR,1,6,CONTRALMIRANTE VILLAR - TUMBES,1366,TUMBES,CONTRALMIRANTE VILLAR,,5,3,3,NO,0,6,MUNICIPAL PROVINCIAL
1296,5019,FUERZA POPULAR,1,10,ZARUMILLA - TUMBES,1366,TUMBES,ZARUMILLA,,5,5,5,NO,0,10,MUNICIPAL PROVINCIAL
1297,15040,ALIANZA PARA EL PROGRESO,1,19,HUARAZ - ANCASH,1257,ANCASH,HUARAZ,,5,10,9,SI,7,12,MUNICIPAL PROVINCIAL
1298,2090,MOVIMIENTO REGIONAL BLOQUE POPULAR JUNIN,1,15,TARMA - JUNIN,2169,JUNIN,TARMA,,5,8,7,SI,5,10,MUNICIPAL PROVINCIAL
1299,12357,MOVIMIENTO REGIONAL AREQUIPA AVANCEMOS,1,8,CONDESUYOS - AREQUIPA,2307,AREQUIPA,CONDESUYOS,,5,4,4,SI,2,6,MUNICIPAL PROVINCIAL
1300,567,MOVIMIENTO REGIONAL AGUA,1,20,ANGARAES - HUANCAVELICA,2681,HUANCAVELICA,ANGARAES,,5,10,10,SI,10,10,MUNICIPAL PROVINCIAL
1301,15131,ALIANZA PARA EL PROGRESO,1,12,SAN MIGUEL - CAJAMARCA,1257,CAJAMARCA,SAN MIGUEL,,5,7,5,SI,4,8,MUNICIPAL PROVINCIAL
1302,7576,JUNTOS POR EL PERU,1,13,HUARAL - LIMA,1264,LIMA,HUARAL,,5,7,6,SI,1,12,MUNICIPAL PROVINCIAL
1303,11778,SOMOS PUEBLO,1,14,EL COLLAO - PUNO,2657,PUNO,EL COLLAO,,5,8,6,SI,4,10,MUNICIPAL PROVINCIAL
1304,9108,TODOS POR EL GRAN CAMBIO,1,13,AMBO - HUANUCO,2712,HUANUCO,AMBO,,5,6,7,SI,3,10,MUNICIPAL PROVINCIAL
1305,5858,REFORMA Y HONRADEZ POR MAS OBRAS,1,23,PUNO - PUNO,2912,PUNO,PUNO,,5,12,11,SI,11,12,MUNICIPAL PROVINCIAL
1306,3263,FUERZA POPULAR,1,13,ALTO AMAZONAS - LORETO,1366,LORETO,ALTO AMAZONAS,,5,6,7,SI,1,12,MUNICIPAL PROVINCIAL
1307,3254,FUERZA POPULAR,1,16,MAYNAS - LORETO,1366,LORETO,MAYNAS,,5,8,8,NO,0,16,MUNICIPAL PROVINCIAL
1308,15171,MOVIMIENTO REGIONAL EL MAICITO,1,8,RECUAY - ANCASH,2245,ANCASH,RECUAY,,5,4,4,SI,2,6,MUNICIPAL PROVINCIAL
1309,13157,MOVIMIENTO REGIONAL AREQUIPA AVANCEMOS,1,30,AREQUIPA - AREQUIPA,2307,AREQUIPA,AREQUIPA,,5,15,15,SI,14,16,MUNICIPAL PROVINCIAL
1310,15145,TRABAJO MAS TRABAJO,1,10,BOLIVAR - LA LIBERTAD,2884,LA LIBERTAD,BOLIVAR,,5,6,4,SI,4,6,MUNICIPAL PROVINCIAL
1311,7603,PARTIDO FRENTE DE LA ESPERANZA 2021,1,14,HUANUCO - HUANUCO,2857,HUANUCO,HUANUCO,,5,8,6,NO,0,14,MUNICIPAL PROVINCIAL
1312,2946,POR TI CALLAO,1,31,CALLAO - CALLAO,2199,CALLAO,CALLAO,,5,16,15,SI,15,16,MUNICIPAL PROVINCIAL
1313,12578,JUNIN RENACE,1,8,JUNIN - JUNIN,2716,JUNIN,JUNIN,,5,4,4,SI,2,6,MUNICIPAL PROVINCIAL
1314,15169,PARTIDO DEMOCRATICO SOMOS PERU,1,8,POMABAMBA - ANCASH,14,ANCASH,POMABAMBA,,5,4,4,NO,0,8,MUNICIPAL PROVINCIAL
1315,15190,MOVIMIENTO INDEPENDIENTE FUERZA REGIONAL,1,10,SECHURA - PIURA,1388,PIURA,SECHURA,,5,6,4,NO,0,10,MUNICIPAL PROVINCIAL
1316,15071,PARTIDO POLITICO NACIONAL PERU LIBRE,1,18,CASMA - ANCASH,2218,ANCASH,CASMA,,5,9,9,SI,8,10,MUNICIPAL PROVINCIAL
1317,5772,PARTIDO FRENTE DE LA ESPERANZA 2021,1,19,AREQUIPA - AREQUIPA,2857,AREQUIPA,AREQUIPA,,5,10,9,SI,3,16,MUNICIPAL PROVINCIAL
1318,15197,PARTIDO POLITICO NACIONAL PERU LIBRE,1,15,HUARAL - LIMA,2218,LIMA,HUARAL,,5,8,7,SI,3,12,MUNICIPAL PROVINCIAL
1319,15179,PASCO VERDE,1,14,PASCO - PASCO,2353,PASCO,PASCO,,5,8,6,SI,2,12,MUNICIPAL PROVINCIAL
1320,12092,PARTIDO PATRIOTICO DEL PERU,1,17,TALARA - PIURA,2869,PIURA,TALARA,,5,8,9,SI,5,12,MUNICIPAL PROVINCIAL
1321,15164,PASCO DIGNIDAD,1,14,OXAPAMPA - PASCO,1705,PASCO,OXAPAMPA,,5,7,7,SI,4,10,MUNICIPAL PROVINCIAL
1322,14613,AUTOGOBIERNO AYLLU,1,13,LA CONVENCION - CUSCO,153,CUSCO,LA CONVENCION,,5,6,7,SI,1,12,MUNICIPAL PROVINCIAL
1323,8181,PARTIDO FRENTE DE LA ESPERANZA 2021,1,11,CANAS - CUSCO,2857,CUSCO,CANAS,,5,6,5,SI,3,8,MUNICIPAL PROVINCIAL
1324,4815,JUNTOS POR EL PERU,1,14,PASCO - PASCO,1264,PASCO,PASCO,,5,8,6,SI,2,12,MUNICIPAL PROVINCIAL
1325,2785,FUERZA POPULAR,1,12,UTCUBAMBA - AMAZONAS,1366,AMAZONAS,UTCUBAMBA,,5,6,6,NO,0,12,MUNICIPAL PROVINCIAL
1326,6701,CORAZON PATRIOTA,1,23,HUANCAYO - JUNIN,2729,JUNIN,HUANCAYO,,5,12,11,SI,7,16,MUNICIPAL PROVINCIAL
1327,5446,PARTIDO FRENTE DE LA ESPERANZA 2021,1,12,ANTA - CUSCO,2857,CUSCO,ANTA,,5,7,5,SI,2,10,MUNICIPAL PROVINCIAL
1328,13993,PROGRESISTA DE APURIMAC,1,11,AYMARAES - APURIMAC,2737,APURIMAC,AYMARAES,,5,6,5,SI,3,8,MUNICIPAL PROVINCIAL
1329,15209,FRENTE POPULAR AGRICOLA FIA DEL PERU,1,20,CALLAO - CALLAO,2901,CALLAO,CALLAO,,5,10,10,SI,4,16,MUNICIPAL PROVINCIAL
1330,15207,MOVIMIENTO REGIONAL BLOQUE POPULAR JUNIN,1,13,JAUJA - JUNIN,2169,JUNIN,JAUJA,,5,7,6,SI,3,10,MUNICIPAL PROVINCIAL
1331,4343,JUNIN SOSTENIBLE CON SU GENTE,1,16,CHUPACA - JUNIN,303,JUNIN,CHUPACA,,5,8,8,SI,6,10,MUNICIPAL PROVINCIAL
1332,15234,RENOVACION POPULAR,1,8,OYON - LIMA,22,LIMA,OYON,,5,4,4,SI,2,6,MUNICIPAL PROVINCIAL
1333,7110,ACCION POPULAR,1,12,HUARAZ - ANCASH,4,ANCASH,HUARAZ,,5,6,6,NO,0,12,MUNICIPAL PROVINCIAL
1334,13528,PARTIDO DEMOCRATICO SOMOS PERU,1,18,PIURA - PIURA,14,PIURA,PIURA,,5,10,8,SI,2,16,MUNICIPAL PROVINCIAL
1335,15222,PARTIDO DEMOCRATICO SOMOS PERU,1,7,TAHUAMANU - MADRE DE DIOS,14,MADRE DE DIOS,TAHUAMANU,,5,4,3,SI,1,6,MUNICIPAL PROVINCIAL
1336,15260,PODEMOS PERU,1,11,CAYLLOMA - AREQUIPA,2731,AREQUIPA,CAYLLOMA,,5,6,5,SI,1,10,MUNICIPAL PROVINCIAL
1337,14209,AUTOGOBIERNO AYLLU,1,14,ESPINAR - CUSCO,153,CUSCO,ESPINAR,,5,8,6,SI,4,10,MUNICIPAL PROVINCIAL
1338,2753,FUERZA POPULAR,2,10,CONDORCANQUI - AMAZONAS,1366,AMAZONAS,CONDORCANQUI,,5,5,5,SI,2,8,MUNICIPAL PROVINCIAL
1339,15253,PARTIDO FRENTE DE LA ESPERANZA 2021,1,13,MARISCAL CACERES - SAN MARTIN,2857,SAN MARTIN,MARISCAL CACERES,,5,7,6,SI,3,10,MUNICIPAL PROVINCIAL
1340,14930,PARTIDO MORADO,1,10,MARISCAL NIETO - MOQUEGUA,2840,MOQUEGUA,MARISCAL NIETO,,5,5,5,NO,0,10,MUNICIPAL PROVINCIAL
1341,2741,FUERZA POPULAR,1,8,CONDORCANQUI - AMAZONAS,1366,AMAZONAS,CONDORCANQUI,,5,4,4,NO,0,8,MUNICIPAL PROVINCIAL
1342,15254,ALIANZA PARA EL PROGRESO,1,8,HUARMEY - ANCASH,1257,ANCASH,HUARMEY,,5,5,3,NO,0,8,MUNICIPAL PROVINCIAL
1343,15233,MOVIMIENTO DE INTEGRACION Y REVOLUCION ANDINA,1,10,HUANCANE - PUNO,2702,PUNO,HUANCANE,,5,6,4,NO,0,10,MUNICIPAL PROVINCIAL
1344,4751,JUNTOS POR EL PERU,1,17,LA CONVENCION - CUSCO,1264,CUSCO,LA CONVENCION,,5,9,8,SI,5,12,MUNICIPAL PROVINCIAL
1345,14512,PARTIDO DEMOCRATICO SOMOS PERU,1,16,CAJAMARCA - CAJAMARCA,14,CAJAMARCA,CAJAMARCA,,5,9,7,SI,2,14,MUNICIPAL PROVINCIAL
1346,2686,FUERZA POPULAR,1,10,BAGUA - AMAZONAS,1366,AMAZONAS,BAGUA,,5,6,4,NO,0,10,MUNICIPAL PROVINCIAL
1347,14794,ALIANZA PARA EL PROGRESO,1,62,LIMA - LIMA,1257,LIMA,LIMA,,5,31,31,SI,22,40,MUNICIPAL PROVINCIAL
1348,1308,PARTIDO FRENTE DE LA ESPERANZA 2021,1,15,LAMBAYEQUE - LAMBAYEQUE,2857,LAMBAYEQUE,LAMBAYEQUE,,5,8,7,SI,1,14,MUNICIPAL PROVINCIAL
1349,15238,MOVIMIENTO REGIONAL REVALORA,1,20,AREQUIPA - AREQUIPA,2719,AREQUIPA,AREQUIPA,,5,11,9,SI,4,16,MUNICIPAL PROVINCIAL
1350,7536,PARTIDO FRENTE DE LA ESPERANZA 2021,1,12,CAMANA - AREQUIPA,2857,AREQUIPA,CAMANA,,5,6,6,SI,2,10,MUNICIPAL PROVINCIAL
1351,7628,PARTIDO FRENTE DE LA ESPERANZA 2021,1,6,LA UNION - AREQUIPA,2857,AREQUIPA,LA UNION,,5,4,2,NO,0,6,MUNICIPAL PROVINCIAL
1352,15246,PARTIDO DEMOCRATICO SOMOS PERU,1,7,LAURICOCHA - HUANUCO,14,HUANUCO,LAURICOCHA,,5,4,3,SI,1,6,MUNICIPAL PROVINCIAL
1353,15202,ALIANZA PARA EL PROGRESO,1,11,ANTA - CUSCO,1257,CUSCO,ANTA,,5,6,5,SI,1,10,MUNICIPAL PROVINCIAL
1354,13671,PARTIDO POLITICO NACIONAL PERU LIBRE,1,21,MELGAR - PUNO,2218,PUNO,MELGAR,,5,11,10,SI,11,10,MUNICIPAL PROVINCIAL
1355,7668,PARTIDO FRENTE DE LA ESPERANZA 2021,1,14,PASCO - PASCO,2857,PASCO,PASCO,,5,8,6,SI,2,12,MUNICIPAL PROVINCIAL
1356,2201,PARTIDO FRENTE DE LA ESPERANZA 2021,1,11,HUARI - ANCASH,2857,ANCASH,HUARI,,5,6,5,SI,1,10,MUNICIPAL PROVINCIAL
1357,6641,JUNTOS POR EL PERU,1,14,CANAS - CUSCO,1264,CUSCO,CANAS,,5,8,6,SI,6,8,MUNICIPAL PROVINCIAL
1358,15293,ALIANZA PARA EL PROGRESO,1,10,MARISCAL LUZURIAGA - ANCASH,1257,ANCASH,MARISCAL LUZURIAGA,,5,6,4,SI,4,6,MUNICIPAL PROVINCIAL
1359,15281,CONCERTACION PARA EL DESARROLLO REGIONAL - LIMA,1,16,HUARAL - LIMA,332,LIMA,HUARAL,,5,8,8,SI,4,12,MUNICIPAL PROVINCIAL
1360,7021,PARTIDO FRENTE DE LA ESPERANZA 2021,1,14,CHINCHA - ICA,2857,ICA,CHINCHA,,5,8,6,SI,2,12,MUNICIPAL PROVINCIAL
1361,12206,REGION PARA TODOS,1,13,TALARA - PIURA,1411,PIURA,TALARA,,5,7,6,SI,1,12,MUNICIPAL PROVINCIAL
1362,14975,FRENTE REGIONAL TUPAC,1,9,ACOMAYO - CUSCO,2911,CUSCO,ACOMAYO,,5,5,4,SI,3,6,MUNICIPAL PROVINCIAL
1363,12832,FE EN EL PERU,1,6,PURUS - UCAYALI,2898,UCAYALI,PURUS,,5,4,2,NO,0,6,MUNICIPAL PROVINCIAL
1364,15210,POR LAS COMUNIDADES FUENTE DE INTEGRACION ANDINA DE PUNO - CONFIA - PUNO,1,15,SAN ANTONIO DE PUTINA - PUNO,2230,PUNO,SAN ANTONIO DE PUTINA,,5,8,7,SI,7,8,MUNICIPAL PROVINCIAL
1365,14788,DEMOCRATA VERDE,1,12,PISCO - ICA,2895,ICA,PISCO,,5,6,6,NO,0,12,MUNICIPAL PROVINCIAL
1366,741,JUNTOS POR EL PERU,1,42,LIMA - LIMA,1264,LIMA,LIMA,,5,21,21,SI,2,40,MUNICIPAL PROVINCIAL
1367,1002,PARTIDO DEMOCRATICO SOMOS PERU,1,16,AYABACA - PIURA,14,PIURA,AYABACA,,5,8,8,SI,4,12,MUNICIPAL PROVINCIAL
1368,15331,PODEMOS PERU,1,19,SANTA - ANCASH,2731,ANCASH,SANTA,,5,10,9,SI,5,14,MUNICIPAL PROVINCIAL
1369,15306,ALIANZA PARA EL PROGRESO,1,19,CALCA - CUSCO,1257,CUSCO,CALCA,,5,10,9,SI,9,10,MUNICIPAL PROVINCIAL
1370,14991,PARTIDO POLITICO NACIONAL PERU LIBRE,1,14,ANTA - CUSCO,2218,CUSCO,ANTA,,5,8,6,SI,4,10,MUNICIPAL PROVINCIAL
1371,8546,PARTIDO FRENTE DE LA ESPERANZA 2021,1,13,ESPINAR - CUSCO,2857,CUSCO,ESPINAR,,5,7,6,SI,3,10,MUNICIPAL PROVINCIAL
1372,15328,ALIANZA PARA EL PROGRESO,1,8,OCROS - ANCASH,1257,ANCASH,OCROS,,5,4,4,SI,2,6,MUNICIPAL PROVINCIAL
1373,15168,MORAL Y DESARROLLO,1,15,PUNO - PUNO,292,PUNO,PUNO,,5,8,7,SI,3,12,MUNICIPAL PROVINCIAL
1374,6140,RENOVACION POPULAR,1,7,CANTA - LIMA,22,LIMA,CANTA,,5,3,4,SI,1,6,MUNICIPAL PROVINCIAL
1375,13152,FUERZA LORETANA,1,10,LORETO - LORETO,61,LORETO,LORETO,,5,5,5,NO,0,10,MUNICIPAL PROVINCIAL
1376,2821,PARTIDO FRENTE DE LA ESPERANZA 2021,1,12,CANCHIS - CUSCO,2857,CUSCO,CANCHIS,,5,7,5,NO,0,12,MUNICIPAL PROVINCIAL
1377,2359,PARTIDO FRENTE DE LA ESPERANZA 2021,1,15,HUARAZ - ANCASH,2857,ANCASH,HUARAZ,,5,8,7,SI,3,12,MUNICIPAL PROVINCIAL
1378,15178,ALIANZA PARA EL PROGRESO,1,10,ACOMAYO - CUSCO,1257,CUSCO,ACOMAYO,,5,6,4,SI,4,6,MUNICIPAL PROVINCIAL
1379,12326,PARTIDO MORADO,1,12,BARRANCA - LIMA,2840,LIMA,BARRANCA,,5,7,5,NO,0,12,MUNICIPAL PROVINCIAL
1380,15344,MOVIMIENTO INDEPENDIENTE POLITICO VOLUNTAD GENERAL AMAZONICA - VOGA ,1,13,UCAYALI - LORETO,2333,LORETO,UCAYALI,,5,7,6,SI,3,10,MUNICIPAL PROVINCIAL
1381,15357,ACCION POPULAR,1,12,NASCA - ICA,4,ICA,NASCA,,5,7,5,SI,2,10,MUNICIPAL PROVINCIAL
1382,15206,PARTIDO FRENTE DE LA ESPERANZA 2021,1,12,MOYOBAMBA - SAN MARTIN,2857,SAN MARTIN,MOYOBAMBA,,5,6,6,NO,0,12,MUNICIPAL PROVINCIAL
1383,15355,ALIANZA PARA EL PROGRESO,1,10,POMABAMBA - ANCASH,1257,ANCASH,POMABAMBA,,5,6,4,SI,2,8,MUNICIPAL PROVINCIAL
1384,3013,PARTIDO FRENTE DE LA ESPERANZA 2021,1,12,QUISPICANCHI - CUSCO,2857,CUSCO,QUISPICANCHI,,5,7,5,SI,2,10,MUNICIPAL PROVINCIAL
1385,2006,PARTIDO POLITICO NACIONAL PERU LIBRE,1,12,CAÑETE - LIMA,2218,LIMA,CAÑETE,,5,7,5,NO,0,12,MUNICIPAL PROVINCIAL
1386,385,PARTIDO DEMOCRATICO SOMOS PERU,1,54,LIMA - LIMA,14,LIMA,LIMA,,5,28,26,SI,14,40,MUNICIPAL PROVINCIAL
1387,9301,PARTIDO FRENTE DE LA ESPERANZA 2021,1,19,ILO - MOQUEGUA,2857,MOQUEGUA,ILO,,5,10,9,SI,9,10,MUNICIPAL PROVINCIAL
1388,13841,PARTIDO DEMOCRATICO SOMOS PERU,1,14,MORROPON - PIURA,14,PIURA,MORROPON,,5,7,7,SI,2,12,MUNICIPAL PROVINCIAL
1389,15350,"AREQUIPA, TRADICION Y FUTURO",1,10,CASTILLA - AREQUIPA,142,AREQUIPA,CASTILLA,,5,5,5,SI,2,8,MUNICIPAL PROVINCIAL
1390,15365,PARTIDO POLITICO NACIONAL PERU LIBRE,1,14,SATIPO - JUNIN,2218,JUNIN,SATIPO,,5,7,7,SI,2,12,MUNICIPAL PROVINCIAL
1391,13761,PROGRESISTA DE APURIMAC,1,10,COTABAMBAS - APURIMAC,2737,APURIMAC,COTABAMBAS,,5,5,5,NO,0,10,MUNICIPAL PROVINCIAL
1392,15090,POR LAS COMUNIDADES FUENTE DE INTEGRACION ANDINA DE PUNO - CONFIA - PUNO,1,20,EL COLLAO - PUNO,2230,PUNO,EL COLLAO,,5,11,9,SI,10,10,MUNICIPAL PROVINCIAL
1393,15392,ALIANZA PARA EL PROGRESO,1,10,SIHUAS - ANCASH,1257,ANCASH,SIHUAS,,5,6,4,SI,2,8,MUNICIPAL PROVINCIAL
1394,15412,PODEMOS PERU,1,9,DANIEL ALCIDES CARRION - PASCO,2731,PASCO,DANIEL ALCIDES CARRION,,5,5,4,SI,1,8,MUNICIPAL PROVINCIAL
1395,15405,ALIANZA PARA EL PROGRESO,1,19,CANCHIS - CUSCO,1257,CUSCO,CANCHIS,,5,10,9,SI,7,12,MUNICIPAL PROVINCIAL
1396,13298,PARTIDO MORADO,1,12,CAÑETE - LIMA,2840,LIMA,CAÑETE,,5,7,5,NO,0,12,MUNICIPAL PROVINCIAL
1397,1584,JUNTOS POR EL PERU,1,11,PAUCARTAMBO - CUSCO,1264,CUSCO,PAUCARTAMBO,,5,6,5,SI,3,8,MUNICIPAL PROVINCIAL
1398,15416,ACCION POPULAR,1,12,MARAÑON - HUANUCO,4,HUANUCO,MARAÑON,,5,7,5,SI,4,8,MUNICIPAL PROVINCIAL
1399,15402,FRENTE REGIONAL TUPAC,1,8,PAUCARTAMBO - CUSCO,2911,CUSCO,PAUCARTAMBO,,5,5,3,NO,0,8,MUNICIPAL PROVINCIAL
1400,15403,PARTIDO DEMOCRATICO SOMOS PERU,1,8,YAROWILCA - HUANUCO,14,HUANUCO,YAROWILCA,,5,5,3,SI,2,6,MUNICIPAL PROVINCIAL
1401,15363,ALIANZA PARA EL PROGRESO,1,10,CANAS - CUSCO,1257,CUSCO,CANAS,,5,6,4,SI,2,8,MUNICIPAL PROVINCIAL
1402,15156,PIURA RENACE,1,18,PIURA - PIURA,2876,PIURA,PIURA,,5,9,9,SI,2,16,MUNICIPAL PROVINCIAL
1403,10098,PARTIDO POLITICO NACIONAL PERU LIBRE,1,24,HUANUCO - HUANUCO,2218,HUANUCO,HUANUCO,,5,13,11,SI,10,14,MUNICIPAL PROVINCIAL
1404,1984,JUNTOS POR EL PERU,1,12,CHUMBIVILCAS - CUSCO,1264,CUSCO,CHUMBIVILCAS,,5,6,6,SI,2,10,MUNICIPAL PROVINCIAL
1405,12937,JUNTOS POR EL PERU,1,7,OCROS - ANCASH,1264,ANCASH,OCROS,,5,4,3,SI,1,6,MUNICIPAL PROVINCIAL
1406,822,CAMINEMOS JUNTOS POR JUNIN,1,17,CHANCHAMAYO - JUNIN,122,JUNIN,CHANCHAMAYO,,5,8,9,SI,5,12,MUNICIPAL PROVINCIAL
1407,826,PARTIDO FRENTE DE LA ESPERANZA 2021,1,18,SANTA - ANCASH,2857,ANCASH,SANTA,,5,10,8,SI,4,14,MUNICIPAL PROVINCIAL
1408,15307,FRENTE REGIONAL DE CAJAMARCA,1,8,SAN PABLO - CAJAMARCA,160,CAJAMARCA,SAN PABLO,,5,5,3,SI,2,6,MUNICIPAL PROVINCIAL
1409,11424,PARTIDO DEMOCRATICO SOMOS PERU,1,16,TALARA - PIURA,14,PIURA,TALARA,,5,8,8,SI,4,12,MUNICIPAL PROVINCIAL
1410,12164,PARTIDO POLITICO NACIONAL PERU LIBRE,1,12,HUARAZ - ANCASH,2218,ANCASH,HUARAZ,,5,6,6,NO,0,12,MUNICIPAL PROVINCIAL
1411,15188,ORGANIZACION POLITICA UNIDAD REGIONAL,1,16,PAITA - PIURA,2711,PIURA,PAITA,,5,8,8,SI,4,12,MUNICIPAL PROVINCIAL
1412,14829,MOVIMIENTO DE INTEGRACION POR EL DESARROLLO REGIONAL (MI CASITA),1,14,CHUCUITO - PUNO,2668,PUNO,CHUCUITO,,5,8,6,SI,4,10,MUNICIPAL PROVINCIAL
1413,15447,ALIANZA PARA EL PROGRESO,2,18,CANCHIS - CUSCO,1257,CUSCO,CANCHIS,,5,10,8,SI,6,12,MUNICIPAL PROVINCIAL
1414,15399,JUNTOS POR EL DESARROLLO DE AREQUIPA,1,14,ISLAY - AREQUIPA,2257,AREQUIPA,ISLAY,,5,8,6,SI,4,10,MUNICIPAL PROVINCIAL
1415,15371,MOVIMIENTO INDEPENDIENTE REGIONAL MI BUEN VECINO,1,10,PACHITEA - HUANUCO,2730,HUANUCO,PACHITEA,,5,5,5,NO,0,10,MUNICIPAL PROVINCIAL
1416,15439,PARTIDO POLITICO NACIONAL PERU LIBRE,1,10,COTABAMBAS - APURIMAC,2218,APURIMAC,COTABAMBAS,,5,6,4,NO,0,10,MUNICIPAL PROVINCIAL
1417,2829,RENOVACION POPULAR,1,16,CUSCO - CUSCO,22,CUSCO,CUSCO,,5,8,8,SI,2,14,MUNICIPAL PROVINCIAL
1418,15476,ALIANZA PARA EL PROGRESO,1,14,CHUMBIVILCAS - CUSCO,1257,CUSCO,CHUMBIVILCAS,,5,8,6,SI,4,10,MUNICIPAL PROVINCIAL
1419,843,PARTIDO FRENTE DE LA ESPERANZA 2021,1,12,CASMA - ANCASH,2857,ANCASH,CASMA,,5,6,6,SI,2,10,MUNICIPAL PROVINCIAL
1420,15507,DEMOCRATA VERDE,1,8,HUALLAGA - SAN MARTIN,2895,SAN MARTIN,HUALLAGA,,5,5,3,NO,0,8,MUNICIPAL PROVINCIAL
1421,5876,HATARIY APURIMAC,1,14,ANDAHUAYLAS - APURIMAC,2886,APURIMAC,ANDAHUAYLAS,,5,8,6,SI,2,12,MUNICIPAL PROVINCIAL
1422,15504,ALIANZA PARA EL PROGRESO,1,23,TAMBOPATA - MADRE DE DIOS,1257,MADRE DE DIOS,TAMBOPATA,,5,12,11,SI,11,12,MUNICIPAL PROVINCIAL
1423,3465,PODEMOS PERU,1,8,CANAS - CUSCO,2731,CUSCO,CANAS,,5,5,3,NO,0,8,MUNICIPAL PROVINCIAL
1424,13966,PARTIDO POLITICO NACIONAL PERU LIBRE,1,16,LA CONVENCION - CUSCO,2218,CUSCO,LA CONVENCION,,5,9,7,SI,4,12,MUNICIPAL PROVINCIAL
1425,5134,JUNTOS POR EL PERU,1,12,CHACHAPOYAS - AMAZONAS,1264,AMAZONAS,CHACHAPOYAS,,5,7,5,SI,2,10,MUNICIPAL PROVINCIAL
1426,15523,PARTIDO POLITICO NACIONAL PERU LIBRE,1,6,RECUAY - ANCASH,2218,ANCASH,RECUAY,,5,3,3,NO,0,6,MUNICIPAL PROVINCIAL
1427,15489,PROGRESISTA DE APURIMAC,1,16,ABANCAY - APURIMAC,2737,APURIMAC,ABANCAY,,5,9,7,SI,4,12,MUNICIPAL PROVINCIAL
1428,15474,MOVIMIENTO REGIONAL AREQUIPA AVANCEMOS,1,12,CASTILLA - AREQUIPA,2307,AREQUIPA,CASTILLA,,5,7,5,SI,4,8,MUNICIPAL PROVINCIAL
1429,15521,DEMOCRATA VERDE,1,12,CUTERVO - CAJAMARCA,2895,CAJAMARCA,CUTERVO,,5,7,5,NO,0,12,MUNICIPAL PROVINCIAL
1430,15513,ALIANZA PARA EL PROGRESO,1,21,CUSCO - CUSCO,1257,CUSCO,CUSCO,,5,11,10,SI,7,14,MUNICIPAL PROVINCIAL
1431,15519,PARTIDO DEMOCRATICO SOMOS PERU,1,8,DOS DE MAYO - HUANUCO,14,HUANUCO,DOS DE MAYO,,5,5,3,NO,0,8,MUNICIPAL PROVINCIAL
1432,15292,MOVIMIENTO REGIONAL WARI LLAQTA,1,17,CANGALLO - AYACUCHO,2706,AYACUCHO,CANGALLO,,5,9,8,SI,9,8,MUNICIPAL PROVINCIAL
1433,15540,ALIANZA PARA EL PROGRESO,1,16,ESPINAR - CUSCO,1257,CUSCO,ESPINAR,,5,8,8,SI,6,10,MUNICIPAL PROVINCIAL
1434,15522,PARTIDO POLITICO NACIONAL PERU LIBRE,1,14,VIRU - LA LIBERTAD,2218,LA LIBERTAD,VIRU,,5,8,6,SI,4,10,MUNICIPAL PROVINCIAL
1435,2363,JUNTOS POR EL PERU,1,14,ABANCAY - APURIMAC,1264,APURIMAC,ABANCAY,,5,8,6,SI,2,12,MUNICIPAL PROVINCIAL
1436,9186,YO AREQUIPA,1,12,CAMANA - AREQUIPA,2744,AREQUIPA,CAMANA,,5,7,5,SI,2,10,MUNICIPAL PROVINCIAL
1437,15539,ALIANZA PARA EL PROGRESO,2,16,SANTA - ANCASH,1257,ANCASH,SANTA,,5,9,7,SI,2,14,MUNICIPAL PROVINCIAL
1438,15484,PARTIDO FRENTE DE LA ESPERANZA 2021,1,12,PUNO - PUNO,2857,PUNO,PUNO,,5,7,5,NO,0,12,MUNICIPAL PROVINCIAL
1439,9319,AVANZA PAIS - PARTIDO DE INTEGRACION SOCIAL,1,18,MAYNAS - LORETO,2173,LORETO,MAYNAS,,5,9,9,SI,2,16,MUNICIPAL PROVINCIAL
1440,4350,RENOVACION POPULAR,1,20,PIURA - PIURA,22,PIURA,PIURA,,5,10,10,SI,4,16,MUNICIPAL PROVINCIAL
1441,15561,ALIANZA PARA EL PROGRESO,1,18,LA CONVENCION - CUSCO,1257,CUSCO,LA CONVENCION,,5,9,9,SI,6,12,MUNICIPAL PROVINCIAL
1442,2291,PARTIDO FRENTE DE LA ESPERANZA 2021,1,12,CARHUAZ - ANCASH,2857,ANCASH,CARHUAZ,,5,7,5,SI,4,8,MUNICIPAL PROVINCIAL
1443,15572,MORAL Y DESARROLLO,1,14,HUANCANE - PUNO,292,PUNO,HUANCANE,,5,8,6,SI,4,10,MUNICIPAL PROVINCIAL
1444,13943,MOVIMIENTO VERDE DE UCAYALI,1,18,PADRE ABAD - UCAYALI,2910,UCAYALI,PADRE ABAD,,5,10,8,SI,8,10,MUNICIPAL PROVINCIAL
1445,871,"MOVIMIENTO POLITICO ""COMPROMISO Y DESARROLLO""",1,12,MARISCAL NIETO - MOQUEGUA,2915,MOQUEGUA,MARISCAL NIETO,,5,6,6,SI,2,10,MUNICIPAL PROVINCIAL
1446,15592,ALIANZA PARA EL PROGRESO,1,10,PARURO - CUSCO,1257,CUSCO,PARURO,,5,6,4,SI,2,8,MUNICIPAL PROVINCIAL
1447,15576,RENOVACION POPULAR,1,13,HUARAL - LIMA,22,LIMA,HUARAL,,5,7,6,SI,1,12,MUNICIPAL PROVINCIAL
1448,15480,GESTIONANDO OBRAS Y OPORTUNIDADES CON LIDERAZGO,2,12,MOHO - PUNO,2667,PUNO,MOHO,,5,7,5,SI,6,6,MUNICIPAL PROVINCIAL
1449,3973,JUNTOS POR EL PERU,1,10,RODRIGUEZ DE MENDOZA - AMAZONAS,1264,AMAZONAS,RODRIGUEZ DE MENDOZA,,5,5,5,SI,2,8,MUNICIPAL PROVINCIAL
1450,14972,PARTIDO POLITICO NACIONAL PERU LIBRE,1,6,SAN PABLO - CAJAMARCA,2218,CAJAMARCA,SAN PABLO,,5,4,2,NO,0,6,MUNICIPAL PROVINCIAL
1451,14274,PARTIDO DEMOCRATICO SOMOS PERU,1,12,CELENDIN - CAJAMARCA,14,CAJAMARCA,CELENDIN,,5,6,6,SI,2,10,MUNICIPAL PROVINCIAL
1452,467,PODEMOS PERU,1,12,CHANCHAMAYO - JUNIN,2731,JUNIN,CHANCHAMAYO,,5,6,6,NO,0,12,MUNICIPAL PROVINCIAL
1453,15491,PARTIDO DEMOCRATICO SOMOS PERU,1,8,PALPA - ICA,14,ICA,PALPA,,5,4,4,SI,2,6,MUNICIPAL PROVINCIAL
1454,13441,FRENTE AMPLIO PARA EL DESARROLLO DEL PUEBLO,1,10,EL COLLAO - PUNO,1670,PUNO,EL COLLAO,,5,5,5,NO,0,10,MUNICIPAL PROVINCIAL
1455,15622,MOVIMIENTO INDEPENDIENTE REGIONAL MI BUEN VECINO,1,9,LAURICOCHA - HUANUCO,2730,HUANUCO,LAURICOCHA,,5,5,4,SI,3,6,MUNICIPAL PROVINCIAL
1456,11004,HATARIY APURIMAC,1,10,CHINCHEROS - APURIMAC,2886,APURIMAC,CHINCHEROS,,5,5,5,SI,2,8,MUNICIPAL PROVINCIAL
1457,4500,RENOVACION POPULAR,1,15,TALARA - PIURA,22,PIURA,TALARA,,5,8,7,SI,3,12,MUNICIPAL PROVINCIAL
1458,15589,JUNTOS POR EL PERU,1,12,ESPINAR - CUSCO,1264,CUSCO,ESPINAR,,5,7,5,SI,2,10,MUNICIPAL PROVINCIAL
1459,3855,PARTIDO FRENTE DE LA ESPERANZA 2021,1,13,URUBAMBA - CUSCO,2857,CUSCO,URUBAMBA,,5,7,6,SI,3,10,MUNICIPAL PROVINCIAL
1460,15608,ALIANZA PARA EL PROGRESO,1,12,PAUCARTAMBO - CUSCO,1257,CUSCO,PAUCARTAMBO,,5,7,5,SI,4,8,MUNICIPAL PROVINCIAL
1461,742,PARTIDO FRENTE DE LA ESPERANZA 2021,1,12,ZARUMILLA - TUMBES,2857,TUMBES,ZARUMILLA,,5,6,6,SI,2,10,MUNICIPAL PROVINCIAL
1462,14581,MOVIMIENTO REGIONAL CONSTRUYENDO,1,22,LAMBAYEQUE - LAMBAYEQUE,1442,LAMBAYEQUE,LAMBAYEQUE,,5,11,11,SI,8,14,MUNICIPAL PROVINCIAL
1463,15638,MORAL Y DESARROLLO,1,10,MELGAR - PUNO,292,PUNO,MELGAR,,5,6,4,NO,0,10,MUNICIPAL PROVINCIAL
1464,2135,JUNTOS POR EL PERU,1,7,ANTABAMBA - APURIMAC,1264,APURIMAC,ANTABAMBA,,5,4,3,SI,1,6,MUNICIPAL PROVINCIAL
1465,3874,JUNTOS POR EL PERU,1,15,UTCUBAMBA - AMAZONAS,1264,AMAZONAS,UTCUBAMBA,,5,8,7,SI,3,12,MUNICIPAL PROVINCIAL
1466,9218,SOCIOS POR ANCASH,1,8,MARISCAL LUZURIAGA - ANCASH,2881,ANCASH,MARISCAL LUZURIAGA,,5,4,4,SI,2,6,MUNICIPAL PROVINCIAL
1467,15634,ALIANZA PARA EL PROGRESO,1,18,PAITA - PIURA,1257,PIURA,PAITA,,5,10,8,SI,6,12,MUNICIPAL PROVINCIAL
1468,8046,PODEMOS PERU,1,8,YAULI - JUNIN,2731,JUNIN,YAULI,,5,4,4,NO,0,8,MUNICIPAL PROVINCIAL
1469,508,PARTIDO FRENTE DE LA ESPERANZA 2021,1,10,CHINCHEROS - APURIMAC,2857,APURIMAC,CHINCHEROS,,5,5,5,SI,2,8,MUNICIPAL PROVINCIAL
1470,748,PARTIDO FRENTE DE LA ESPERANZA 2021,1,8,CONTRALMIRANTE VILLAR - TUMBES,2857,TUMBES,CONTRALMIRANTE VILLAR,,5,4,4,SI,2,6,MUNICIPAL PROVINCIAL
1471,15620,FRENTE POPULAR AGRICOLA FIA DEL PERU,1,17,SANTA - ANCASH,2901,ANCASH,SANTA,,5,8,9,SI,3,14,MUNICIPAL PROVINCIAL
1472,15655,ACCION POPULAR,1,9,YAROWILCA - HUANUCO,4,HUANUCO,YAROWILCA,,5,5,4,SI,3,6,MUNICIPAL PROVINCIAL
1473,15263,MOVIMIENTO INDEPENDIENTE TRABAJANDO PARA TODOS,1,12,ANGARAES - HUANCAVELICA,226,HUANCAVELICA,ANGARAES,,5,7,5,SI,2,10,MUNICIPAL PROVINCIAL
1474,14200,PARTIDO POLITICO NACIONAL PERU LIBRE,1,12,YUNGAY - ANCASH,2218,ANCASH,YUNGAY,,5,6,6,SI,2,10,MUNICIPAL PROVINCIAL
1475,15647,ALIANZA PARA EL PROGRESO,1,13,QUISPICANCHI - CUSCO,1257,CUSCO,QUISPICANCHI,,5,7,6,SI,3,10,MUNICIPAL PROVINCIAL
1476,15488,ALIANZA PARA EL PROGRESO,1,16,SANTA - ANCASH,1257,ANCASH,SANTA,,5,9,7,SI,2,14,MUNICIPAL PROVINCIAL
1477,4477,RENOVACION POPULAR,1,14,PAITA - PIURA,22,PIURA,PAITA,,5,7,7,SI,2,12,MUNICIPAL PROVINCIAL
1478,4899,JUNTOS POR EL PERU,1,10,LUYA - AMAZONAS,1264,AMAZONAS,LUYA,,5,5,5,SI,2,8,MUNICIPAL PROVINCIAL
1479,4479,RENOVACION POPULAR,1,16,SULLANA - PIURA,22,PIURA,SULLANA,,5,9,7,SI,2,14,MUNICIPAL PROVINCIAL
1480,14266,MOVIMIENTO REGIONAL INKA PACHAKUTEQ,1,9,ACOMAYO - CUSCO,2368,CUSCO,ACOMAYO,,5,5,4,SI,3,6,MUNICIPAL PROVINCIAL
1481,15681,ALIANZA PARA EL PROGRESO,1,14,URUBAMBA - CUSCO,1257,CUSCO,URUBAMBA,,5,8,6,SI,4,10,MUNICIPAL PROVINCIAL
1482,14112,PARTIDO POLITICO NACIONAL PERU LIBRE,1,10,HUAYTARA - HUANCAVELICA,2218,HUANCAVELICA,HUAYTARA,,5,5,5,SI,4,6,MUNICIPAL PROVINCIAL
1483,15575,MOVIMIENTO REGIONAL DEL AJO AREQUIPA CON JUSTICIA Y ORDEN,1,17,AREQUIPA - AREQUIPA,2920,AREQUIPA,AREQUIPA,,5,9,8,SI,1,16,MUNICIPAL PROVINCIAL
1484,15692,MOVIMIENTO REGIONAL AREQUIPA AVANCEMOS,1,13,CAYLLOMA - AREQUIPA,2307,AREQUIPA,CAYLLOMA,,5,6,7,SI,3,10,MUNICIPAL PROVINCIAL
1485,15700,ALIANZA PARA EL PROGRESO,1,15,AYABACA - PIURA,1257,PIURA,AYABACA,,5,8,7,SI,3,12,MUNICIPAL PROVINCIAL
1486,11937,PARTIDO POLITICO NACIONAL PERU LIBRE,1,26,CUSCO - CUSCO,2218,CUSCO,CUSCO,,5,14,12,SI,12,14,MUNICIPAL PROVINCIAL
1487,3548,JUNTOS POR EL PERU,1,10,OXAPAMPA - PASCO,1264,PASCO,OXAPAMPA,,5,5,5,NO,0,10,MUNICIPAL PROVINCIAL
1488,7300,ACCION POPULAR,1,9,EL DORADO - SAN MARTIN,4,SAN MARTIN,EL DORADO,,5,5,4,SI,1,8,MUNICIPAL PROVINCIAL
1489,15165,ALIANZA POR NUESTRO DESARROLLO,1,18,HUAMANGA - AYACUCHO,2710,AYACUCHO,HUAMANGA,,5,10,8,SI,6,12,MUNICIPAL PROVINCIAL
1490,11938,MOVIMIENTO REGIONAL AGUA,1,18,CANGALLO - AYACUCHO,2861,AYACUCHO,CANGALLO,,5,10,8,SI,10,8,MUNICIPAL PROVINCIAL
1491,15669,PARTIDO DEMOCRATICO SOMOS PERU,1,17,BARRANCA - LIMA,14,LIMA,BARRANCA,,5,9,8,SI,5,12,MUNICIPAL PROVINCIAL
1492,15378,RENOVACION POPULAR,1,12,CHANCHAMAYO - JUNIN,22,JUNIN,CHANCHAMAYO,,5,7,5,NO,0,12,MUNICIPAL PROVINCIAL
1493,15461,MOVIMIENTO VERDE DE UCAYALI,1,10,PURUS - UCAYALI,2910,UCAYALI,PURUS,,5,4,6,SI,4,6,MUNICIPAL PROVINCIAL
1494,15677,MOVIMIENTO REGIONAL FORTALEZA PERU,1,12,ASCOPE - LA LIBERTAD,2738,LA LIBERTAD,ASCOPE,,5,6,6,NO,0,12,MUNICIPAL PROVINCIAL
1495,15721,DEMOCRATA VERDE,1,14,CHINCHA - ICA,2895,ICA,CHINCHA,,5,8,6,SI,2,12,MUNICIPAL PROVINCIAL
1496,12918,ACCION POPULAR,1,10,CONCEPCION - JUNIN,4,JUNIN,CONCEPCION,,5,6,4,NO,0,10,MUNICIPAL PROVINCIAL
1497,15486,FRENTE REGIONAL DE CAJAMARCA,1,17,CELENDIN - CAJAMARCA,160,CAJAMARCA,CELENDIN,,5,9,8,SI,7,10,MUNICIPAL PROVINCIAL
1498,12871,PARTIDO POLITICO NACIONAL PERU LIBRE,2,12,MORROPON - PIURA,2218,PIURA,MORROPON,,5,6,6,NO,0,12,MUNICIPAL PROVINCIAL
1499,12618,PARTIDO POLITICO NACIONAL PERU LIBRE,1,18,AMBO - HUANUCO,2218,HUANUCO,AMBO,,5,9,9,SI,8,10,MUNICIPAL PROVINCIAL
1500,12939,ACCION POPULAR,1,18,HUANCAYO - JUNIN,4,JUNIN,HUANCAYO,,5,9,9,SI,2,16,MUNICIPAL PROVINCIAL
1501,4839,PODEMOS PERU,1,11,CARAVELI - AREQUIPA,2731,AREQUIPA,CARAVELI,,5,6,5,SI,3,8,MUNICIPAL PROVINCIAL
1502,15425,TRABAJO MAS TRABAJO,1,12,ASCOPE - LA LIBERTAD,2884,LA LIBERTAD,ASCOPE,,5,6,6,NO,0,12,MUNICIPAL PROVINCIAL
1503,12948,ACCION POPULAR,1,10,JAUJA - JUNIN,4,JUNIN,JAUJA,,5,6,4,NO,0,10,MUNICIPAL PROVINCIAL
1504,8034,PARTIDO FRENTE DE LA ESPERANZA 2021,1,8,YUNGUYO - PUNO,2857,PUNO,YUNGUYO,,5,5,3,NO,0,8,MUNICIPAL PROVINCIAL
1505,10438,PARTIDO POLITICO NACIONAL PERU LIBRE,2,14,SULLANA - PIURA,2218,PIURA,SULLANA,,5,7,7,NO,0,14,MUNICIPAL PROVINCIAL
1506,15761,ALIANZA POR NUESTRO DESARROLLO,1,10,HUANCA SANCOS - AYACUCHO,2710,AYACUCHO,HUANCA SANCOS,,5,6,4,SI,4,6,MUNICIPAL PROVINCIAL
1507,15787,PODEMOS PERU,1,10,MARAÑON - HUANUCO,2731,HUANUCO,MARAÑON,,5,6,4,SI,2,8,MUNICIPAL PROVINCIAL
1508,15768,MOVIMIENTO DE INTEGRACION Y REVOLUCION ANDINA,1,12,PUNO - PUNO,2702,PUNO,PUNO,,5,7,5,NO,0,12,MUNICIPAL PROVINCIAL
1509,12927,ACCION POPULAR,1,12,SATIPO - JUNIN,4,JUNIN,SATIPO,,5,6,6,NO,0,12,MUNICIPAL PROVINCIAL
1510,5352,JUNTOS POR EL PERU,1,14,RIOJA - SAN MARTIN,1264,SAN MARTIN,RIOJA,,5,7,7,SI,2,12,MUNICIPAL PROVINCIAL
1511,15377,SOCIOS POR ANCASH,1,10,CARHUAZ - ANCASH,2881,ANCASH,CARHUAZ,,5,6,4,SI,2,8,MUNICIPAL PROVINCIAL
1512,13959,PODER ANDINO,1,12,HUANCANE - PUNO,2338,PUNO,HUANCANE,,5,7,5,SI,2,10,MUNICIPAL PROVINCIAL
1513,15731,MOVIMIENTO REGIONAL AREQUIPA AVANCEMOS,2,10,CAYLLOMA - AREQUIPA,2307,AREQUIPA,CAYLLOMA,,5,6,4,NO,0,10,MUNICIPAL PROVINCIAL
1514,12978,ACCION POPULAR,1,12,CHANCHAMAYO - JUNIN,4,JUNIN,CHANCHAMAYO,,5,6,6,NO,0,12,MUNICIPAL PROVINCIAL
1515,15544,PARTIDO POLITICO NACIONAL PERU LIBRE,1,16,ABANCAY - APURIMAC,2218,APURIMAC,ABANCAY,,5,9,7,SI,4,12,MUNICIPAL PROVINCIAL
1516,4954,JUNTOS POR EL PERU,1,10,CONDORCANQUI - AMAZONAS,1264,AMAZONAS,CONDORCANQUI,,5,6,4,SI,2,8,MUNICIPAL PROVINCIAL
1517,15775,PARTIDO DEMOCRATICO SOMOS PERU,1,14,HUANUCO - HUANUCO,14,HUANUCO,HUANUCO,,5,8,6,NO,0,14,MUNICIPAL PROVINCIAL
1518,3942,PODEMOS PERU,1,12,HUARAZ - ANCASH,2731,ANCASH,HUARAZ,,5,6,6,NO,0,12,MUNICIPAL PROVINCIAL
1519,7362,ACCION POPULAR,1,14,BARRANCA - LIMA,4,LIMA,BARRANCA,,5,8,6,SI,2,12,MUNICIPAL PROVINCIAL
1520,4372,JUNTOS POR EL PERU,1,12,PISCO - ICA,1264,ICA,PISCO,,5,6,6,NO,0,12,MUNICIPAL PROVINCIAL
1521,15762,JUNIN SOSTENIBLE CON SU GENTE,1,14,JAUJA - JUNIN,303,JUNIN,JAUJA,,5,7,7,SI,4,10,MUNICIPAL PROVINCIAL
1522,9714,PARTIDO FRENTE DE LA ESPERANZA 2021,1,13,AZANGARO - PUNO,2857,PUNO,AZANGARO,,5,7,6,SI,1,12,MUNICIPAL PROVINCIAL
1523,3784,JUNTOS POR EL PERU,1,10,NASCA - ICA,1264,ICA,NASCA,,5,5,5,NO,0,10,MUNICIPAL PROVINCIAL
1524,15813,ALIANZA PARA EL PROGRESO,1,15,ASCOPE - LA LIBERTAD,1257,LA LIBERTAD,ASCOPE,,5,7,8,SI,3,12,MUNICIPAL PROVINCIAL
1525,6537,"AREQUIPA, TRADICION Y FUTURO",1,15,CAYLLOMA - AREQUIPA,142,AREQUIPA,CAYLLOMA,,5,8,7,SI,5,10,MUNICIPAL PROVINCIAL
1526,5163,JUNTOS POR EL PERU,1,10,GENERAL SANCHEZ CERRO - MOQUEGUA,1264,MOQUEGUA,GENERAL SANCHEZ CERRO,,5,6,4,SI,4,6,MUNICIPAL PROVINCIAL
1527,15837,PARTIDO POLITICO NACIONAL PERU LIBRE,1,10,HUARI - ANCASH,2218,ANCASH,HUARI,,5,5,5,NO,0,10,MUNICIPAL PROVINCIAL
1528,14883,MOVIMIENTO REGIONAL INKA PACHAKUTEQ,1,10,CANAS - CUSCO,2368,CUSCO,CANAS,,5,6,4,SI,2,8,MUNICIPAL PROVINCIAL
1529,15641,FRENTE AMPLIO PARA EL DESARROLLO DEL PUEBLO,1,21,SAN ROMAN - PUNO,1670,PUNO,SAN ROMAN,,5,11,10,SI,7,14,MUNICIPAL PROVINCIAL
1530,11973,PARTIDO MORADO,1,6,ACOMAYO - CUSCO,2840,CUSCO,ACOMAYO,,5,4,2,NO,0,6,MUNICIPAL PROVINCIAL
1531,15851,DEMOCRATA VERDE,1,12,CHEPEN - LA LIBERTAD,2895,LA LIBERTAD,CHEPEN,,5,6,6,SI,2,10,MUNICIPAL PROVINCIAL
1532,11979,PARTIDO MORADO,1,10,QUISPICANCHI - CUSCO,2840,CUSCO,QUISPICANCHI,,5,6,4,NO,0,10,MUNICIPAL PROVINCIAL
1533,15820,JUNIN RENACE,1,15,SATIPO - JUNIN,2716,JUNIN,SATIPO,,5,8,7,SI,3,12,MUNICIPAL PROVINCIAL
1534,729,PARTIDO FRENTE DE LA ESPERANZA 2021,1,17,TACNA - TACNA,2857,TACNA,TACNA,,5,8,9,SI,3,14,MUNICIPAL PROVINCIAL
1535,1114,AREQUIPA - UNIDOS POR EL GRAN CAMBIO,1,24,AREQUIPA - AREQUIPA,2261,AREQUIPA,AREQUIPA,,5,13,11,SI,8,16,MUNICIPAL PROVINCIAL
1536,15766,PARTIDO MORADO,1,12,TUMBES - TUMBES,2840,TUMBES,TUMBES,,5,6,6,NO,0,12,MUNICIPAL PROVINCIAL
1537,7962,PARTIDO FRENTE DE LA ESPERANZA 2021,1,11,EL COLLAO - PUNO,2857,PUNO,EL COLLAO,,5,6,5,SI,1,10,MUNICIPAL PROVINCIAL
1538,15733,GESTIONANDO OBRAS Y OPORTUNIDADES CON LIDERAZGO,1,18,PUNO - PUNO,2667,PUNO,PUNO,,5,10,8,SI,6,12,MUNICIPAL PROVINCIAL
1539,15814,HATARIY APURIMAC,1,10,AYMARAES - APURIMAC,2886,APURIMAC,AYMARAES,,5,5,5,SI,2,8,MUNICIPAL PROVINCIAL
1540,15842,AVANZA PAIS - PARTIDO DE INTEGRACION SOCIAL,1,14,CAÑETE - LIMA,2173,LIMA,CAÑETE,,5,7,7,SI,2,12,MUNICIPAL PROVINCIAL
1541,15835,ALIANZA GOBIERNO UNIDAD Y ACCION,1,9,SIHUAS - ANCASH,2856,ANCASH,SIHUAS,,5,5,4,SI,1,8,MUNICIPAL PROVINCIAL
1542,15703,POR LAS COMUNIDADES FUENTE DE INTEGRACION ANDINA DE PUNO - CONFIA - PUNO,1,28,PUNO - PUNO,2230,PUNO,PUNO,,5,14,14,SI,16,12,MUNICIPAL PROVINCIAL
1543,15624,PARTIDO FRENTE DE LA ESPERANZA 2021,1,10,LAMPA - PUNO,2857,PUNO,LAMPA,,5,6,4,SI,2,8,MUNICIPAL PROVINCIAL
1544,12000,PARTIDO MORADO,1,15,CUSCO - CUSCO,2840,CUSCO,CUSCO,,5,8,7,SI,1,14,MUNICIPAL PROVINCIAL
1545,15850,MOVIMIENTO REGIONAL AGUA,1,16,HUANCAVELICA - HUANCAVELICA,2681,HUANCAVELICA,HUANCAVELICA,,5,9,7,SI,4,12,MUNICIPAL PROVINCIAL
1546,15873,DEMOCRATA VERDE,2,12,BARRANCA - LIMA,2895,LIMA,BARRANCA,,5,7,5,NO,0,12,MUNICIPAL PROVINCIAL
1547,15736,PARTIDO POLITICO NACIONAL PERU LIBRE,2,16,HUAURA - LIMA,2218,LIMA,HUAURA,,5,9,7,SI,4,12,MUNICIPAL PROVINCIAL
1548,15795,PROGRESISTA DE APURIMAC,1,12,ANDAHUAYLAS - APURIMAC,2737,APURIMAC,ANDAHUAYLAS,,5,6,6,NO,0,12,MUNICIPAL PROVINCIAL
1549,15803,JUNIN RENACE,1,18,HUANCAYO - JUNIN,2716,JUNIN,HUANCAYO,,5,9,9,SI,2,16,MUNICIPAL PROVINCIAL
1550,4578,RENOVACION POPULAR,1,11,CASMA - ANCASH,22,ANCASH,CASMA,,5,6,5,SI,1,10,MUNICIPAL PROVINCIAL
1551,15580,PARTIDO FRENTE DE LA ESPERANZA 2021,1,13,FERREÑAFE - LAMBAYEQUE,2857,LAMBAYEQUE,FERREÑAFE,,5,7,6,SI,1,12,MUNICIPAL PROVINCIAL
1552,15586,ORGANIZACION POLITICA UNIDAD REGIONAL,1,16,SULLANA - PIURA,2711,PIURA,SULLANA,,5,9,7,SI,2,14,MUNICIPAL PROVINCIAL
1553,298,CAMINEMOS JUNTOS POR JUNIN,1,11,CONCEPCION - JUNIN,122,JUNIN,CONCEPCION,,5,6,5,SI,1,10,MUNICIPAL PROVINCIAL
1554,9997,HATARIY APURIMAC,1,8,ANTABAMBA - APURIMAC,2886,APURIMAC,ANTABAMBA,,5,5,3,SI,2,6,MUNICIPAL PROVINCIAL
1555,15876,SOCIOS POR ANCASH,1,16,HUARAZ - ANCASH,2881,ANCASH,HUARAZ,,5,9,7,SI,4,12,MUNICIPAL PROVINCIAL
1556,7941,PARTIDO FRENTE DE LA ESPERANZA 2021,1,14,HUAMANGA - AYACUCHO,2857,AYACUCHO,HUAMANGA,,5,8,6,SI,2,12,MUNICIPAL PROVINCIAL
1557,15116,PARTIDO DEMOCRATICO SOMOS PERU,1,10,VILCAS HUAMAN - AYACUCHO,14,AYACUCHO,VILCAS HUAMAN,,5,5,5,SI,4,6,MUNICIPAL PROVINCIAL
1558,7077,JUNTOS POR EL PERU,1,11,CHUPACA - JUNIN,1264,JUNIN,CHUPACA,,5,6,5,SI,1,10,MUNICIPAL PROVINCIAL
1559,4289,PARTIDO DEMOCRATICO SOMOS PERU,1,12,YAUYOS - LIMA,14,LIMA,YAUYOS,,5,7,5,SI,6,6,MUNICIPAL PROVINCIAL
1560,15905,MOVIMIENTO REGIONAL UNIDAD CIVICA LIMA,1,8,YAUYOS - LIMA,2306,LIMA,YAUYOS,,5,5,3,SI,2,6,MUNICIPAL PROVINCIAL
1561,7395,ACCION POPULAR,1,6,OYON - LIMA,4,LIMA,OYON,,5,4,2,NO,0,6,MUNICIPAL PROVINCIAL
1562,15728,POR LAS COMUNIDADES FUENTE DE INTEGRACION ANDINA DE PUNO - CONFIA - PUNO,1,15,HUANCANE - PUNO,2230,PUNO,HUANCANE,,5,8,7,SI,5,10,MUNICIPAL PROVINCIAL
1563,14913,MOVIMIENTO REGIONAL AMAZONENSE UNIDOS AL CAMPO,1,14,BAGUA - AMAZONAS,40,AMAZONAS,BAGUA,,5,8,6,SI,4,10,MUNICIPAL PROVINCIAL
1564,7764,HATARIY APURIMAC,1,14,ABANCAY - APURIMAC,2886,APURIMAC,ABANCAY,,5,7,7,SI,2,12,MUNICIPAL PROVINCIAL
1565,15884,MORAL Y DESARROLLO,1,12,MOHO - PUNO,292,PUNO,MOHO,,5,7,5,SI,6,6,MUNICIPAL PROVINCIAL
1566,12607,MOVIMIENTO REGIONAL SIERRA Y SELVA CONTIGO JUNIN,1,46,HUANCAYO - JUNIN,2680,JUNIN,HUANCAYO,,5,24,22,SI,30,16,MUNICIPAL PROVINCIAL
1567,15817,TRABAJO MAS TRABAJO,1,12,PATAZ - LA LIBERTAD,2884,LA LIBERTAD,PATAZ,,5,7,5,SI,2,10,MUNICIPAL PROVINCIAL
1568,15856,MOVIMIENTO REGIONAL BLOQUE POPULAR JUNIN,1,8,JUNIN - JUNIN,2169,JUNIN,JUNIN,,5,5,3,SI,2,6,MUNICIPAL PROVINCIAL
1569,3928,PODEMOS PERU,1,12,CASMA - ANCASH,2731,ANCASH,CASMA,,5,6,6,SI,2,10,MUNICIPAL PROVINCIAL
1570,15878,KAUSACHUN,1,10,GENERAL SANCHEZ CERRO - MOQUEGUA,2381,MOQUEGUA,GENERAL SANCHEZ CERRO,,5,5,5,SI,4,6,MUNICIPAL PROVINCIAL
1571,12637,DEMOCRATA VERDE,1,10,CONCEPCION - JUNIN,2895,JUNIN,CONCEPCION,,5,4,6,NO,0,10,MUNICIPAL PROVINCIAL
1572,736,JUNTOS POR EL PERU,1,14,TAMBOPATA - MADRE DE DIOS,1264,MADRE DE DIOS,TAMBOPATA,,5,7,7,SI,2,12,MUNICIPAL PROVINCIAL
1573,452,PODEMOS PERU,1,14,ICA - ICA,2731,ICA,ICA,,5,7,7,NO,0,14,MUNICIPAL PROVINCIAL
1574,7688,PARTIDO FRENTE DE LA ESPERANZA 2021,1,12,LA MAR - AYACUCHO,2857,AYACUCHO,LA MAR,,5,7,5,SI,2,10,MUNICIPAL PROVINCIAL
1575,7399,ACCION POPULAR,1,8,YAUYOS - LIMA,4,LIMA,YAUYOS,,5,5,3,SI,2,6,MUNICIPAL PROVINCIAL
1576,8716,DEMOCRATA VERDE,1,12,HUARAL - LIMA,2895,LIMA,HUARAL,,5,6,6,NO,0,12,MUNICIPAL PROVINCIAL
1577,15903,RENOVACION POPULAR,1,10,HUAROCHIRI - LIMA,22,LIMA,HUAROCHIRI,,5,5,5,NO,0,10,MUNICIPAL PROVINCIAL
1578,6653,JUNTOS POR EL PERU,1,12,SATIPO - JUNIN,1264,JUNIN,SATIPO,,5,7,5,NO,0,12,MUNICIPAL PROVINCIAL
1579,14974,MOVIMIENTO REGIONAL SIERRA Y SELVA CONTIGO JUNIN,1,11,JAUJA - JUNIN,2680,JUNIN,JAUJA,,5,6,5,SI,1,10,MUNICIPAL PROVINCIAL
1580,6240,JUNTOS POR EL PERU,1,12,CAMANA - AREQUIPA,1264,AREQUIPA,CAMANA,,5,6,6,SI,2,10,MUNICIPAL PROVINCIAL
1581,7487,ACCION POPULAR,3,15,SAN MARTIN - SAN MARTIN,4,SAN MARTIN,SAN MARTIN,,5,8,7,SI,3,12,MUNICIPAL PROVINCIAL
1582,15955,SOCIOS POR ANCASH,1,6,RECUAY - ANCASH,2881,ANCASH,RECUAY,,5,4,2,NO,0,6,MUNICIPAL PROVINCIAL
1583,15938,CONTIGO REGION,1,16,HUANCABAMBA - PIURA,2862,PIURA,HUANCABAMBA,,5,9,7,SI,4,12,MUNICIPAL PROVINCIAL
1584,15811,POR LAS COMUNIDADES FUENTE DE INTEGRACION ANDINA DE PUNO - CONFIA - PUNO,1,19,CHUCUITO - PUNO,2230,PUNO,CHUCUITO,,5,10,9,SI,9,10,MUNICIPAL PROVINCIAL
1585,5967,JUNTOS POR EL PERU,1,12,URUBAMBA - CUSCO,1264,CUSCO,URUBAMBA,,5,6,6,SI,2,10,MUNICIPAL PROVINCIAL
1586,13302,RENOVACION POPULAR,1,9,YAUYOS - LIMA,22,LIMA,YAUYOS,,5,5,4,SI,3,6,MUNICIPAL PROVINCIAL
1587,15947,"AREQUIPA, TRADICION Y FUTURO",1,10,CONDESUYOS - AREQUIPA,142,AREQUIPA,CONDESUYOS,,5,5,5,SI,4,6,MUNICIPAL PROVINCIAL
1588,805,POR LAS COMUNIDADES FUENTE DE INTEGRACION ANDINA DE PUNO - CONFIA - PUNO,1,15,MELGAR - PUNO,2230,PUNO,MELGAR,,5,8,7,SI,5,10,MUNICIPAL PROVINCIAL
1589,1523,RENOVACION POPULAR,1,19,SANTA - ANCASH,22,ANCASH,SANTA,,5,10,9,SI,5,14,MUNICIPAL PROVINCIAL
1590,12217,FE EN EL PERU,1,8,DANIEL ALCIDES CARRION - PASCO,2898,PASCO,DANIEL ALCIDES CARRION,,5,5,3,NO,0,8,MUNICIPAL PROVINCIAL
1591,15216,POR LAS COMUNIDADES FUENTE DE INTEGRACION ANDINA DE PUNO - CONFIA - PUNO,1,27,SAN ROMAN - PUNO,2230,PUNO,SAN ROMAN,,5,14,13,SI,13,14,MUNICIPAL PROVINCIAL
1592,6476,MOVIMIENTO ACCION REGIONAL,1,20,SAN ROMAN - PUNO,2866,PUNO,SAN ROMAN,,5,11,9,SI,6,14,MUNICIPAL PROVINCIAL
1593,14689,MOVIMIENTO POLITICO CAMBIEMOS X HCO,1,12,PACHITEA - HUANUCO,2733,HUANUCO,PACHITEA,,5,7,5,SI,2,10,MUNICIPAL PROVINCIAL
1594,15841,JUNTOS POR EL PERU,1,19,AREQUIPA - AREQUIPA,1264,AREQUIPA,AREQUIPA,,5,9,10,SI,3,16,MUNICIPAL PROVINCIAL
1595,7401,ACCION POPULAR,1,14,RIOJA - SAN MARTIN,4,SAN MARTIN,RIOJA,,5,8,6,SI,2,12,MUNICIPAL PROVINCIAL
1596,14590,AUTOGOBIERNO AYLLU,1,12,URUBAMBA - CUSCO,153,CUSCO,URUBAMBA,,5,6,6,SI,2,10,MUNICIPAL PROVINCIAL
1597,15824,FRENTE POPULAR AGRICOLA FIA DEL PERU,1,53,LIMA - LIMA,2901,LIMA,LIMA,,5,27,26,SI,13,40,MUNICIPAL PROVINCIAL
1598,15928,MOVIMIENTO REGIONAL AMAZONENSE UNIDOS AL CAMPO,1,18,UTCUBAMBA - AMAZONAS,40,AMAZONAS,UTCUBAMBA,,5,9,9,SI,6,12,MUNICIPAL PROVINCIAL
1599,15982,PARTIDO DEMOCRATICO SOMOS PERU,1,10,PACHITEA - HUANUCO,14,HUANUCO,PACHITEA,,5,5,5,NO,0,10,MUNICIPAL PROVINCIAL
1600,13566,MOVIMIENTO ACCION REGIONAL,1,16,PUNO - PUNO,2866,PUNO,PUNO,,5,9,7,SI,4,12,MUNICIPAL PROVINCIAL
1601,16035,ALIANZA PARA EL PROGRESO,1,6,BOLIVAR - LA LIBERTAD,1257,LA LIBERTAD,BOLIVAR,,5,4,2,NO,0,6,MUNICIPAL PROVINCIAL
1602,10798,JUNTOS POR EL PERU,1,15,CAYLLOMA - AREQUIPA,1264,AREQUIPA,CAYLLOMA,,5,8,7,SI,5,10,MUNICIPAL PROVINCIAL
1603,4972,JUNTOS POR EL PERU,2,10,CONDORCANQUI - AMAZONAS,1264,AMAZONAS,CONDORCANQUI,,5,6,4,SI,2,8,MUNICIPAL PROVINCIAL
1604,10936,MOVIMIENTO INDEPENDIENTE REGIONAL PURO ANCASH,1,15,HUARAZ - ANCASH,1474,ANCASH,HUARAZ,,5,8,7,SI,3,12,MUNICIPAL PROVINCIAL
1605,15914,MOVIMIENTO POLITICO REGIONAL ENERGIA COMUNAL AMAZONICA,2,10,CONDORCANQUI - AMAZONAS,2229,AMAZONAS,CONDORCANQUI,,5,5,5,SI,2,8,MUNICIPAL PROVINCIAL
1606,13795,PARTIDO MORADO,1,19,AREQUIPA - AREQUIPA,2840,AREQUIPA,AREQUIPA,,5,10,9,SI,3,16,MUNICIPAL PROVINCIAL
1607,15847,AVANZADA REGIONAL INDEPENDIENTE UNIDOS POR HUANUCO,1,8,LAURICOCHA - HUANUCO,2201,HUANUCO,LAURICOCHA,,5,5,3,SI,2,6,MUNICIPAL PROVINCIAL
1608,16023,MOVIMIENTO REGIONAL GANA AYACUCHO,1,11,PARINACOCHAS - AYACUCHO,2694,AYACUCHO,PARINACOCHAS,,5,6,5,SI,3,8,MUNICIPAL PROVINCIAL
1609,15265,JUNTOS POR EL PERU,1,14,SAN ROMAN - PUNO,1264,PUNO,SAN ROMAN,,5,8,6,NO,0,14,MUNICIPAL PROVINCIAL
1610,16055,PARTIDO DEMOCRATICO SOMOS PERU,1,10,LUCANAS - AYACUCHO,14,AYACUCHO,LUCANAS,,5,5,5,NO,0,10,MUNICIPAL PROVINCIAL
1611,16073,PODEMOS PERU,1,14,HUANUCO - HUANUCO,2731,HUANUCO,HUANUCO,,5,7,7,NO,0,14,MUNICIPAL PROVINCIAL
1612,16081,PARTIDO POLITICO NACIONAL PERU LIBRE,1,6,BOLIVAR - LA LIBERTAD,2218,LA LIBERTAD,BOLIVAR,,5,3,3,NO,0,6,MUNICIPAL PROVINCIAL
1613,8325,PARTIDO POLITICO NACIONAL PERU LIBRE,1,14,BELLAVISTA - SAN MARTIN,2218,SAN MARTIN,BELLAVISTA,,5,7,7,SI,4,10,MUNICIPAL PROVINCIAL
1614,15628,PARTIDO DEMOCRATICO SOMOS PERU,1,15,ICA - ICA,14,ICA,ICA,,5,8,7,SI,1,14,MUNICIPAL PROVINCIAL
1615,16046,MORAL Y DESARROLLO,1,10,CHUCUITO - PUNO,292,PUNO,CHUCUITO,,5,6,4,NO,0,10,MUNICIPAL PROVINCIAL
1616,10117,PARTIDO POLITICO NACIONAL PERU LIBRE,1,18,TOCACHE - SAN MARTIN,2218,SAN MARTIN,TOCACHE,,5,10,8,SI,8,10,MUNICIPAL PROVINCIAL
1617,16008,PARTIDO DEMOCRATICO SOMOS PERU,1,16,SANTA - ANCASH,14,ANCASH,SANTA,,5,9,7,SI,2,14,MUNICIPAL PROVINCIAL
1618,15468,REFORMA Y HONRADEZ POR MAS OBRAS,1,19,SAN ROMAN - PUNO,2912,PUNO,SAN ROMAN,,5,10,9,SI,5,14,MUNICIPAL PROVINCIAL
1619,6264,JUNTOS POR EL PERU,1,11,ISLAY - AREQUIPA,1264,AREQUIPA,ISLAY,,5,6,5,SI,1,10,MUNICIPAL PROVINCIAL
1620,15220,AVANZA PAIS - PARTIDO DE INTEGRACION SOCIAL,1,10,YUNGAY - ANCASH,2173,ANCASH,YUNGAY,,5,6,4,NO,0,10,MUNICIPAL PROVINCIAL
1621,4672,JUNTOS POR EL PERU,1,12,FERREÑAFE - LAMBAYEQUE,1264,LAMBAYEQUE,FERREÑAFE,,5,7,5,NO,0,12,MUNICIPAL PROVINCIAL
1622,16113,ALIANZA PARA EL PROGRESO,1,14,CHEPEN - LA LIBERTAD,1257,LA LIBERTAD,CHEPEN,,5,7,7,SI,4,10,MUNICIPAL PROVINCIAL
1623,16129,REGION PARA TODOS,1,13,AYABACA - PIURA,1411,PIURA,AYABACA,,5,7,6,SI,1,12,MUNICIPAL PROVINCIAL
1624,16147,ALIANZA PARA EL PROGRESO,1,9,CANTA - LIMA,1257,LIMA,CANTA,,5,5,4,SI,3,6,MUNICIPAL PROVINCIAL
1625,15693,NUEVA AMAZONIA,1,8,PICOTA - SAN MARTIN,51,SAN MARTIN,PICOTA,,5,5,3,NO,0,8,MUNICIPAL PROVINCIAL
1626,8361,FE EN EL PERU,1,16,BARRANCA - LIMA,2898,LIMA,BARRANCA,,5,9,7,SI,4,12,MUNICIPAL PROVINCIAL
1627,2906,JUNTOS POR EL PERU,1,18,CALLAO - CALLAO,1264,CALLAO,CALLAO,,5,8,10,SI,2,16,MUNICIPAL PROVINCIAL
1628,16119,CONCERTACION PARA EL DESARROLLO REGIONAL - LIMA,1,16,HUAURA - LIMA,332,LIMA,HUAURA,,5,9,7,SI,4,12,MUNICIPAL PROVINCIAL
1629,14994,PARTIDO POLITICO NACIONAL PERU LIBRE,1,10,SUCRE - AYACUCHO,2218,AYACUCHO,SUCRE,,5,5,5,SI,4,6,MUNICIPAL PROVINCIAL
1630,15199,MOVIMIENTO DE INTEGRACION POR EL DESARROLLO REGIONAL (MI CASITA),1,16,EL COLLAO - PUNO,2668,PUNO,EL COLLAO,,5,8,8,SI,6,10,MUNICIPAL PROVINCIAL
1631,12105,PARTIDO POLITICO NACIONAL PERU LIBRE,2,8,YAROWILCA - HUANUCO,2218,HUANUCO,YAROWILCA,,5,5,3,SI,2,6,MUNICIPAL PROVINCIAL
1632,12198,PARTIDO POLITICO NACIONAL PERU LIBRE,1,12,CAMANA - AREQUIPA,2218,AREQUIPA,CAMANA,,5,6,6,SI,2,10,MUNICIPAL PROVINCIAL
1633,14728,CAMINEMOS JUNTOS POR JUNIN,1,31,HUANCAYO - JUNIN,122,JUNIN,HUANCAYO,,5,16,15,SI,15,16,MUNICIPAL PROVINCIAL
1634,16156,ALIANZA PARA EL PROGRESO,1,9,OYON - LIMA,1257,LIMA,OYON,,5,5,4,SI,3,6,MUNICIPAL PROVINCIAL
1635,16158,PARTIDO FRENTE DE LA ESPERANZA 2021,1,10,HUARMEY - ANCASH,2857,ANCASH,HUARMEY,,5,5,5,SI,2,8,MUNICIPAL PROVINCIAL
1636,16197,ALIANZA PARA EL PROGRESO,1,12,GRAN CHIMU - LA LIBERTAD,1257,LA LIBERTAD,GRAN CHIMU,,5,7,5,SI,4,8,MUNICIPAL PROVINCIAL
1637,8773,PARTIDO FRENTE DE LA ESPERANZA 2021,1,10,CHUPACA - JUNIN,2857,JUNIN,CHUPACA,,5,5,5,NO,0,10,MUNICIPAL PROVINCIAL
1638,16111,MOVIMIENTO INDEPENDIENTE TRABAJANDO PARA TODOS,1,10,CASTROVIRREYNA - HUANCAVELICA,226,HUANCAVELICA,CASTROVIRREYNA,,5,6,4,SI,4,6,MUNICIPAL PROVINCIAL
1639,16180,FRENTE POPULAR AGRICOLA FIA DEL PERU,1,10,RODRIGUEZ DE MENDOZA - AMAZONAS,2901,AMAZONAS,RODRIGUEZ DE MENDOZA,,5,5,5,SI,2,8,MUNICIPAL PROVINCIAL
1640,13255,PARTIDO POLITICO NACIONAL PERU LIBRE,1,12,LA UNION - AREQUIPA,2218,AREQUIPA,LA UNION,,5,7,5,SI,6,6,MUNICIPAL PROVINCIAL
1641,3558,JUNTOS POR EL PERU,1,10,ACOMAYO - CUSCO,1264,CUSCO,ACOMAYO,,5,6,4,SI,4,6,MUNICIPAL PROVINCIAL
1642,12120,PARTIDO POLITICO NACIONAL PERU LIBRE,2,8,LAURICOCHA - HUANUCO,2218,HUANUCO,LAURICOCHA,,5,4,4,SI,2,6,MUNICIPAL PROVINCIAL
1643,7929,PARTIDO FRENTE DE LA ESPERANZA 2021,1,12,ALTO AMAZONAS - LORETO,2857,LORETO,ALTO AMAZONAS,,5,6,6,NO,0,12,MUNICIPAL PROVINCIAL
1644,12390,MOVIMIENTO INDEPENDIENTE FUERZA REGIONAL,1,13,TALARA - PIURA,1388,PIURA,TALARA,,5,7,6,SI,1,12,MUNICIPAL PROVINCIAL
1645,16028,PARTIDO POLITICO NACIONAL PERU LIBRE,1,17,TAYACAJA - HUANCAVELICA,2218,HUANCAVELICA,TAYACAJA,,5,8,9,SI,7,10,MUNICIPAL PROVINCIAL
1646,8466,PARTIDO FRENTE DE LA ESPERANZA 2021,1,6,PURUS - UCAYALI,2857,UCAYALI,PURUS,,5,3,3,NO,0,6,MUNICIPAL PROVINCIAL
1647,14981,ALIANZA PARA EL PROGRESO,1,6,AIJA - ANCASH,1257,ANCASH,AIJA,,5,4,2,NO,0,6,MUNICIPAL PROVINCIAL
1648,15998,PARTIDO DEMOCRATICO SOMOS PERU,1,24,TRUJILLO - LA LIBERTAD,14,LA LIBERTAD,TRUJILLO,,5,13,11,SI,8,16,MUNICIPAL PROVINCIAL
1649,16225,DEMOCRATA VERDE,1,12,HUANCABAMBA - PIURA,2895,PIURA,HUANCABAMBA,,5,7,5,NO,0,12,MUNICIPAL PROVINCIAL
1650,16217,AUTOGOBIERNO AYLLU,2,10,URUBAMBA - CUSCO,153,CUSCO,URUBAMBA,,5,6,4,NO,0,10,MUNICIPAL PROVINCIAL
1651,16143,MOVIMIENTO POLITICO CAMBIEMOS X HCO,1,8,LAURICOCHA - HUANUCO,2733,HUANUCO,LAURICOCHA,,5,4,4,SI,2,6,MUNICIPAL PROVINCIAL
1652,8187,REFORMA Y HONRADEZ POR MAS OBRAS,1,14,SANDIA - PUNO,2912,PUNO,SANDIA,,5,8,6,SI,4,10,MUNICIPAL PROVINCIAL
1653,11018,PARTIDO PATRIOTICO DEL PERU,1,55,LIMA - LIMA,2869,LIMA,LIMA,,5,28,27,SI,15,40,MUNICIPAL PROVINCIAL
1654,12155,PARTIDO POLITICO NACIONAL PERU LIBRE,2,12,LEONCIO PRADO - HUANUCO,2218,HUANUCO,LEONCIO PRADO,,5,6,6,NO,0,12,MUNICIPAL PROVINCIAL
1655,15750,PODEMOS PERU,1,8,CANDARAVE - TACNA,2731,TACNA,CANDARAVE,,5,4,4,SI,2,6,MUNICIPAL PROVINCIAL
1656,15466,PARTIDO POLITICO NACIONAL PERU LIBRE,1,6,TARATA - TACNA,2218,TACNA,TARATA,,5,4,2,NO,0,6,MUNICIPAL PROVINCIAL
1657,13547,REFORMA Y HONRADEZ POR MAS OBRAS,1,14,CHUCUITO - PUNO,2912,PUNO,CHUCUITO,,5,8,6,SI,4,10,MUNICIPAL PROVINCIAL
1658,16239,SOMOS PUEBLO,1,10,MOHO - PUNO,2657,PUNO,MOHO,,5,6,4,SI,4,6,MUNICIPAL PROVINCIAL
1659,12180,PARTIDO POLITICO NACIONAL PERU LIBRE,2,10,HUAMALIES - HUANUCO,2218,HUANUCO,HUAMALIES,,5,5,5,NO,0,10,MUNICIPAL PROVINCIAL
1660,8488,ACCION POPULAR,1,9,CHURCAMPA - HUANCAVELICA,4,HUANCAVELICA,CHURCAMPA,,5,4,5,SI,1,8,MUNICIPAL PROVINCIAL
1661,16262,ALIANZA PARA EL PROGRESO,1,8,JULCAN - LA LIBERTAD,1257,LA LIBERTAD,JULCAN,,5,5,3,NO,0,8,MUNICIPAL PROVINCIAL
1662,15380,"FRENTE INDEPENDIENTE ALIANZA REGIONAL F.I.A.R.- ""NUEVA GENERACION """,1,14,HUANUCO - HUANUCO,2709,HUANUCO,HUANUCO,,5,8,6,NO,0,14,MUNICIPAL PROVINCIAL
1663,12496,PARTIDO POLITICO NACIONAL PERU LIBRE,2,7,HUACAYBAMBA - HUANUCO,2218,HUANUCO,HUACAYBAMBA,,5,4,3,SI,1,6,MUNICIPAL PROVINCIAL
1664,14916,PARTIDO POLITICO NACIONAL PERU LIBRE,1,14,EL COLLAO - PUNO,2218,PUNO,EL COLLAO,,5,7,7,SI,4,10,MUNICIPAL PROVINCIAL
1665,11872,PARTIDO POLITICO NACIONAL PERU LIBRE,1,16,MAYNAS - LORETO,2218,LORETO,MAYNAS,,5,9,7,NO,0,16,MUNICIPAL PROVINCIAL
1666,7972,FUERZA POPULAR,1,16,HUANCAYO - JUNIN,1366,JUNIN,HUANCAYO,,5,9,7,NO,0,16,MUNICIPAL PROVINCIAL
1667,12757,PARTIDO POLITICO NACIONAL PERU LIBRE,2,11,DOS DE MAYO - HUANUCO,2218,HUANUCO,DOS DE MAYO,,5,6,5,SI,3,8,MUNICIPAL PROVINCIAL
1668,9567,PARTIDO POLITICO NACIONAL PERU LIBRE,1,21,SANTA - ANCASH,2218,ANCASH,SANTA,,5,11,10,SI,7,14,MUNICIPAL PROVINCIAL
1669,15198,ALIANZA PARA EL PROGRESO,1,11,HUARI - ANCASH,1257,ANCASH,HUARI,,5,6,5,SI,1,10,MUNICIPAL PROVINCIAL
1670,16188,SUMATE,1,20,SANCHEZ CARRION - LA LIBERTAD,67,LA LIBERTAD,SANCHEZ CARRION,,5,11,9,SI,8,12,MUNICIPAL PROVINCIAL
1671,16279,SOMOS PUEBLO,1,16,CHUCUITO - PUNO,2657,PUNO,CHUCUITO,,5,8,8,SI,6,10,MUNICIPAL PROVINCIAL
1672,15084,PARTIDO POLITICO NACIONAL PERU LIBRE,1,14,PUNO - PUNO,2218,PUNO,PUNO,,5,7,7,SI,2,12,MUNICIPAL PROVINCIAL
1673,13693,PARTIDO POLITICO NACIONAL PERU LIBRE,1,13,CAYLLOMA - AREQUIPA,2218,AREQUIPA,CAYLLOMA,,5,7,6,SI,3,10,MUNICIPAL PROVINCIAL
1674,13766,PARTIDO POLITICO NACIONAL PERU LIBRE,1,12,MARISCAL CACERES - SAN MARTIN,2218,SAN MARTIN,MARISCAL CACERES,,5,7,5,SI,2,10,MUNICIPAL PROVINCIAL
1675,15763,FE EN EL PERU,1,7,YAUYOS - LIMA,2898,LIMA,YAUYOS,,5,3,4,SI,1,6,MUNICIPAL PROVINCIAL
1676,489,PODEMOS PERU,1,15,JAUJA - JUNIN,2731,JUNIN,JAUJA,,5,8,7,SI,5,10,MUNICIPAL PROVINCIAL
1677,11386,ALIANZA PARA EL PROGRESO,1,13,MARISCAL NIETO - MOQUEGUA,1257,MOQUEGUA,MARISCAL NIETO,,5,7,6,SI,3,10,MUNICIPAL PROVINCIAL
1678,16251,MOVIMIENTO REGIONAL REVALORA,1,8,LA UNION - AREQUIPA,2719,AREQUIPA,LA UNION,,5,4,4,SI,2,6,MUNICIPAL PROVINCIAL
1679,16321,ALIANZA PARA EL PROGRESO,1,12,CARAVELI - AREQUIPA,1257,AREQUIPA,CARAVELI,,5,7,5,SI,4,8,MUNICIPAL PROVINCIAL
1680,16221,AUTOGOBIERNO AYLLU,1,10,CANAS - CUSCO,153,CUSCO,CANAS,,5,5,5,SI,2,8,MUNICIPAL PROVINCIAL
1681,10215,FUERZA INKA AMAZONICA,1,19,LA CONVENCION - CUSCO,2164,CUSCO,LA CONVENCION,,5,10,9,SI,7,12,MUNICIPAL PROVINCIAL
1682,16181,SOMOS PUEBLO,1,10,YUNGUYO - PUNO,2657,PUNO,YUNGUYO,,5,5,5,SI,2,8,MUNICIPAL PROVINCIAL
1683,16334,ALIANZA PARA EL PROGRESO,1,9,YAROWILCA - HUANUCO,1257,HUANUCO,YAROWILCA,,5,5,4,SI,3,6,MUNICIPAL PROVINCIAL
1684,1780,JUNTOS POR EL PERU,1,15,BARRANCA - LIMA,1264,LIMA,BARRANCA,,5,8,7,SI,3,12,MUNICIPAL PROVINCIAL
1685,16314,MOVIMIENTO POLITICO REGIONAL SUMATE AL CAMBIO,1,8,GENERAL SANCHEZ CERRO - MOQUEGUA,2891,MOQUEGUA,GENERAL SANCHEZ CERRO,,5,5,3,SI,2,6,MUNICIPAL PROVINCIAL
1686,16335,ALIANZA PARA EL PROGRESO,1,13,ISLAY - AREQUIPA,1257,AREQUIPA,ISLAY,,5,7,6,SI,3,10,MUNICIPAL PROVINCIAL
1687,16176,MOVIMIENTO VERDE DE UCAYALI,1,19,ATALAYA - UCAYALI,2910,UCAYALI,ATALAYA,,5,9,10,SI,9,10,MUNICIPAL PROVINCIAL
1688,16307,ALIANZA PARA EL PROGRESO,1,15,SANCHEZ CARRION - LA LIBERTAD,1257,LA LIBERTAD,SANCHEZ CARRION,,5,8,7,SI,3,12,MUNICIPAL PROVINCIAL
1689,16350,ALIANZA PARA EL PROGRESO,1,13,CASTILLA - AREQUIPA,1257,AREQUIPA,CASTILLA,,5,7,6,SI,5,8,MUNICIPAL PROVINCIAL
1690,16292,FRENTE AMPLIO PARA EL DESARROLLO DEL PUEBLO,1,8,MOHO - PUNO,1670,PUNO,MOHO,,5,5,3,SI,2,6,MUNICIPAL PROVINCIAL
1691,13890,FUERZA POPULAR,1,12,HUARAL - LIMA,1366,LIMA,HUARAL,,5,6,6,NO,0,12,MUNICIPAL PROVINCIAL
1692,16254,MOVIMIENTO REGIONAL VIVA TACNA,1,11,JORGE BASADRE - TACNA,2693,TACNA,JORGE BASADRE,,5,6,5,SI,5,6,MUNICIPAL PROVINCIAL
1693,16339,ALIANZA PARA EL PROGRESO,1,9,GENERAL SANCHEZ CERRO - MOQUEGUA,1257,MOQUEGUA,GENERAL SANCHEZ CERRO,,5,5,4,SI,3,6,MUNICIPAL PROVINCIAL
1694,16208,MOVIMIENTO VERDE DE UCAYALI,1,14,CORONEL PORTILLO - UCAYALI,2910,UCAYALI,CORONEL PORTILLO,,5,7,7,NO,0,14,MUNICIPAL PROVINCIAL
1695,15073,REFORMA Y HONRADEZ POR MAS OBRAS,1,12,CARABAYA - PUNO,2912,PUNO,CARABAYA,,5,7,5,SI,2,10,MUNICIPAL PROVINCIAL
1696,16370,ALIANZA PARA EL PROGRESO,1,23,AREQUIPA - AREQUIPA,1257,AREQUIPA,AREQUIPA,,5,12,11,SI,7,16,MUNICIPAL PROVINCIAL
1697,16048,FRENTE AMPLIO PARA EL DESARROLLO DEL PUEBLO,1,23,PUNO - PUNO,1670,PUNO,PUNO,,5,12,11,SI,11,12,MUNICIPAL PROVINCIAL
1698,15134,PARTIDO POLITICO NACIONAL PERU LIBRE,1,6,GRAU - APURIMAC,2218,APURIMAC,GRAU,,5,4,2,NO,0,6,MUNICIPAL PROVINCIAL
1699,16342,PARTIDO DEMOCRATICO SOMOS PERU,1,12,LEONCIO PRADO - HUANUCO,14,HUANUCO,LEONCIO PRADO,,5,7,5,NO,0,12,MUNICIPAL PROVINCIAL
1700,16289,ACCION POPULAR,2,10,PICOTA - SAN MARTIN,4,SAN MARTIN,PICOTA,,5,6,4,SI,2,8,MUNICIPAL PROVINCIAL
1701,13083,PARTIDO POLITICO NACIONAL PERU LIBRE,1,10,VILCAS HUAMAN - AYACUCHO,2218,AYACUCHO,VILCAS HUAMAN,,5,5,5,SI,4,6,MUNICIPAL PROVINCIAL
1702,16275,MOVIMIENTO INDEPENDIENTE TRABAJANDO PARA TODOS,1,12,ACOBAMBA - HUANCAVELICA,226,HUANCAVELICA,ACOBAMBA,,5,7,5,SI,4,8,MUNICIPAL PROVINCIAL
1703,15983,AVANZA PAIS - PARTIDO DE INTEGRACION SOCIAL,2,17,CHICLAYO - LAMBAYEQUE,2173,LAMBAYEQUE,CHICLAYO,,5,8,9,SI,1,16,MUNICIPAL PROVINCIAL
1704,16402,MOVIMIENTO DE INTEGRACION Y REVOLUCION ANDINA,1,12,CHUCUITO - PUNO,2702,PUNO,CHUCUITO,,5,7,5,SI,2,10,MUNICIPAL PROVINCIAL
1705,16385,MOVIMIENTO INDEPENDIENTE TRABAJANDO PARA TODOS,1,19,HUANCAVELICA - HUANCAVELICA,226,HUANCAVELICA,HUANCAVELICA,,5,10,9,SI,7,12,MUNICIPAL PROVINCIAL
1706,13535,MOVIMIENTO REGIONAL VIVA TACNA,1,6,CANDARAVE - TACNA,2693,TACNA,CANDARAVE,,5,3,3,NO,0,6,MUNICIPAL PROVINCIAL
1707,16419,ALIANZA PARA EL PROGRESO,1,10,ANTONIO RAIMONDI - ANCASH,1257,ANCASH,ANTONIO RAIMONDI,,5,5,5,SI,4,6,MUNICIPAL PROVINCIAL
1708,2284,JUNTOS POR EL PERU,1,11,PARURO - CUSCO,1264,CUSCO,PARURO,,5,6,5,SI,3,8,MUNICIPAL PROVINCIAL
1709,15434,AUTOGOBIERNO AYLLU,1,10,CHUMBIVILCAS - CUSCO,153,CUSCO,CHUMBIVILCAS,,5,6,4,NO,0,10,MUNICIPAL PROVINCIAL
1710,11798,PARTIDO POLITICO NACIONAL PERU LIBRE,1,10,MARISCAL RAMON CASTILLA - LORETO,2218,LORETO,MARISCAL RAMON CASTILLA,,5,6,4,NO,0,10,MUNICIPAL PROVINCIAL
1711,1487,PARTIDO FRENTE DE LA ESPERANZA 2021,1,19,MARISCAL NIETO - MOQUEGUA,2857,MOQUEGUA,MARISCAL NIETO,,5,10,9,SI,9,10,MUNICIPAL PROVINCIAL
1712,16312,PARTIDO POLITICO NACIONAL PERU LIBRE,1,18,TRUJILLO - LA LIBERTAD,2218,LA LIBERTAD,TRUJILLO,,5,10,8,SI,2,16,MUNICIPAL PROVINCIAL
1713,16384,FRENTE POPULAR AGRICOLA FIA DEL PERU,1,14,TAYACAJA - HUANCAVELICA,2901,HUANCAVELICA,TAYACAJA,,5,7,7,SI,4,10,MUNICIPAL PROVINCIAL
1714,16439,PARTIDO DEMOCRATICO SOMOS PERU,1,10,PALLASCA - ANCASH,14,ANCASH,PALLASCA,,5,6,4,SI,2,8,MUNICIPAL PROVINCIAL
1715,16449,ALIANZA PARA EL PROGRESO,1,14,ILO - MOQUEGUA,1257,MOQUEGUA,ILO,,5,8,6,SI,4,10,MUNICIPAL PROVINCIAL
1716,16463,ALIANZA PARA EL PROGRESO,1,18,JAUJA - JUNIN,1257,JUNIN,JAUJA,,5,10,8,SI,8,10,MUNICIPAL PROVINCIAL
1717,16455,MOVIMIENTO REGIONAL WARI LLAQTA,1,11,VILCAS HUAMAN - AYACUCHO,2706,AYACUCHO,VILCAS HUAMAN,,5,6,5,SI,5,6,MUNICIPAL PROVINCIAL
1718,15898,SOMOS PUEBLO,1,8,LAMPA - PUNO,2657,PUNO,LAMPA,,5,5,3,NO,0,8,MUNICIPAL PROVINCIAL
1719,16362,PARTIDO POLITICO NACIONAL PERU LIBRE,1,16,ILO - MOQUEGUA,2218,MOQUEGUA,ILO,,5,9,7,SI,6,10,MUNICIPAL PROVINCIAL
1720,15255,PARTIDO POLITICO NACIONAL PERU LIBRE,1,18,URUBAMBA - CUSCO,2218,CUSCO,URUBAMBA,,5,10,8,SI,8,10,MUNICIPAL PROVINCIAL
1721,2932,JUNTOS POR EL PERU,1,16,CUSCO - CUSCO,1264,CUSCO,CUSCO,,5,8,8,SI,2,14,MUNICIPAL PROVINCIAL
1722,16049,PARTIDO POLITICO NACIONAL PERU LIBRE,1,15,CHOTA - CAJAMARCA,2218,CAJAMARCA,CHOTA,,5,8,7,SI,3,12,MUNICIPAL PROVINCIAL
1723,16475,MOVIMIENTO POLITICO REGIONAL ENERGIA COMUNAL AMAZONICA,3,10,BAGUA - AMAZONAS,2229,AMAZONAS,BAGUA,,5,5,5,NO,0,10,MUNICIPAL PROVINCIAL
1724,14571,MOVIMIENTO REGIONAL BICENTENARIO,1,11,OTUZCO - LA LIBERTAD,2906,LA LIBERTAD,OTUZCO,,5,6,5,SI,1,10,MUNICIPAL PROVINCIAL
1725,16481,ALIANZA PARA EL PROGRESO,2,17,HUARAZ - ANCASH,1257,ANCASH,HUARAZ,,5,9,8,SI,5,12,MUNICIPAL PROVINCIAL
1726,16451,PODER ANDINO,1,12,MELGAR - PUNO,2338,PUNO,MELGAR,,5,7,5,SI,2,10,MUNICIPAL PROVINCIAL
1727,7679,AVANZA PAIS - PARTIDO DE INTEGRACION SOCIAL,1,16,SULLANA - PIURA,2173,PIURA,SULLANA,,5,8,8,SI,2,14,MUNICIPAL PROVINCIAL
1728,16472,MOVIMIENTO REGIONAL GANA AYACUCHO,1,11,VILCAS HUAMAN - AYACUCHO,2694,AYACUCHO,VILCAS HUAMAN,,5,6,5,SI,5,6,MUNICIPAL PROVINCIAL
1729,14707,ACCION POPULAR,1,13,PASCO - PASCO,4,PASCO,PASCO,,5,7,6,SI,1,12,MUNICIPAL PROVINCIAL
1730,16325,FRENTE POPULAR AGRICOLA FIA DEL PERU,1,12,CASMA - ANCASH,2901,ANCASH,CASMA,,5,6,6,SI,2,10,MUNICIPAL PROVINCIAL
1731,16457,AUTOGOBIERNO AYLLU,1,9,PARURO - CUSCO,153,CUSCO,PARURO,,5,5,4,SI,1,8,MUNICIPAL PROVINCIAL
1732,5943,AVANZA PAIS - PARTIDO DE INTEGRACION SOCIAL,1,10,ATALAYA - UCAYALI,2173,UCAYALI,ATALAYA,,5,5,5,NO,0,10,MUNICIPAL PROVINCIAL
1733,3114,JUNTOS POR EL PERU,1,14,CANCHIS - CUSCO,1264,CUSCO,CANCHIS,,5,7,7,SI,2,12,MUNICIPAL PROVINCIAL
1734,16508,ALIANZA PARA EL PROGRESO,1,22,SATIPO - JUNIN,1257,JUNIN,SATIPO,,5,12,10,SI,10,12,MUNICIPAL PROVINCIAL
1735,16487,PARTIDO POLITICO NACIONAL PERU LIBRE,1,15,LUCANAS - AYACUCHO,2218,AYACUCHO,LUCANAS,,5,8,7,SI,5,10,MUNICIPAL PROVINCIAL
1736,16510,ALIANZA PARA EL PROGRESO,1,12,SANTIAGO DE CHUCO - LA LIBERTAD,1257,LA LIBERTAD,SANTIAGO DE CHUCO,,5,7,5,SI,2,10,MUNICIPAL PROVINCIAL
1737,5247,AVANZA PAIS - PARTIDO DE INTEGRACION SOCIAL,1,14,PADRE ABAD - UCAYALI,2173,UCAYALI,PADRE ABAD,,5,7,7,SI,4,10,MUNICIPAL PROVINCIAL
1738,5204,AVANZA PAIS - PARTIDO DE INTEGRACION SOCIAL,1,6,PURUS - UCAYALI,2173,UCAYALI,PURUS,,5,4,2,NO,0,6,MUNICIPAL PROVINCIAL
1739,9667,PARTIDO FRENTE DE LA ESPERANZA 2021,1,12,LUCANAS - AYACUCHO,2857,AYACUCHO,LUCANAS,,5,7,5,SI,2,10,MUNICIPAL PROVINCIAL
1740,16509,PARTIDO DEMOCRATICO SOMOS PERU,1,10,HUARI - ANCASH,14,ANCASH,HUARI,,5,6,4,NO,0,10,MUNICIPAL PROVINCIAL
1741,11784,REFORMA Y HONRADEZ POR MAS OBRAS,1,13,YUNGUYO - PUNO,2912,PUNO,YUNGUYO,,5,7,6,SI,5,8,MUNICIPAL PROVINCIAL
1742,16189,MOVIMIENTO REGIONAL AMAZONENSE UNIDOS AL CAMPO,1,12,CHACHAPOYAS - AMAZONAS,40,AMAZONAS,CHACHAPOYAS,,5,6,6,SI,2,10,MUNICIPAL PROVINCIAL
1743,11957,PARTIDO POLITICO NACIONAL PERU LIBRE,1,32,CARABAYA - PUNO,2218,PUNO,CARABAYA,,5,17,15,SI,22,10,MUNICIPAL PROVINCIAL
1744,16537,ALIANZA PARA EL PROGRESO,1,10,PATAZ - LA LIBERTAD,1257,LA LIBERTAD,PATAZ,,5,5,5,NO,0,10,MUNICIPAL PROVINCIAL
1745,7373,ACCION POPULAR,1,6,CANTA - LIMA,4,LIMA,CANTA,,5,4,2,NO,0,6,MUNICIPAL PROVINCIAL
1746,12021,MOVIMIENTO REGIONAL BLOQUE POPULAR JUNIN,1,24,HUANCAYO - JUNIN,2169,JUNIN,HUANCAYO,,5,12,12,SI,8,16,MUNICIPAL PROVINCIAL
1747,16513,PARTIDO MORADO,1,14,SANTA - ANCASH,2840,ANCASH,SANTA,,5,8,6,NO,0,14,MUNICIPAL PROVINCIAL
1748,13829,JUNTOS POR EL PERU,1,9,YAULI - JUNIN,1264,JUNIN,YAULI,,5,5,4,SI,1,8,MUNICIPAL PROVINCIAL
1749,16157,MOVIMIENTO REGIONAL DEL AJO AREQUIPA CON JUSTICIA Y ORDEN,1,6,LA UNION - AREQUIPA,2920,AREQUIPA,LA UNION,,5,2,4,NO,0,6,MUNICIPAL PROVINCIAL
1750,12334,ACCION POPULAR,1,12,MARISCAL RAMON CASTILLA - LORETO,4,LORETO,MARISCAL RAMON CASTILLA,,5,6,6,SI,2,10,MUNICIPAL PROVINCIAL
1751,16458,PARTIDO POLITICO NACIONAL PERU LIBRE,1,13,RIOJA - SAN MARTIN,2218,SAN MARTIN,RIOJA,,5,7,6,SI,1,12,MUNICIPAL PROVINCIAL
1752,10471,PODER ANDINO,1,11,CARABAYA - PUNO,2338,PUNO,CARABAYA,,5,6,5,SI,1,10,MUNICIPAL PROVINCIAL
1753,16566,ALIANZA PARA EL PROGRESO,1,14,VIRU - LA LIBERTAD,1257,LA LIBERTAD,VIRU,,5,8,6,SI,4,10,MUNICIPAL PROVINCIAL
1754,16559,ALIANZA PARA EL PROGRESO,1,8,LA UNION - AREQUIPA,1257,AREQUIPA,LA UNION,,5,5,3,SI,2,6,MUNICIPAL PROVINCIAL
1755,7159,JUNTOS POR EL PERU,1,12,CALCA - CUSCO,1264,CUSCO,CALCA,,5,7,5,SI,2,10,MUNICIPAL PROVINCIAL
1756,16553,ALIANZA POR NUESTRO DESARROLLO,1,9,VICTOR FAJARDO - AYACUCHO,2710,AYACUCHO,VICTOR FAJARDO,,5,5,4,SI,3,6,MUNICIPAL PROVINCIAL
1757,7385,ACCION POPULAR,1,14,HUARAL - LIMA,4,LIMA,HUARAL,,5,8,6,SI,2,12,MUNICIPAL PROVINCIAL
1758,10885,PARTIDO POLITICO NACIONAL PERU LIBRE,1,10,LORETO - LORETO,2218,LORETO,LORETO,,5,6,4,NO,0,10,MUNICIPAL PROVINCIAL
1759,7387,ACCION POPULAR,1,10,HUAROCHIRI - LIMA,4,LIMA,HUAROCHIRI,,5,5,5,NO,0,10,MUNICIPAL PROVINCIAL
1760,12343,ACCION POPULAR,1,6,PUTUMAYO - LORETO,4,LORETO,PUTUMAYO,,5,4,2,NO,0,6,MUNICIPAL PROVINCIAL
1761,16495,MOVIMIENTO REGIONAL SIERRA Y SELVA CONTIGO JUNIN,1,14,SATIPO - JUNIN,2680,JUNIN,SATIPO,,5,8,6,SI,2,12,MUNICIPAL PROVINCIAL
1762,7391,ACCION POPULAR,1,14,HUAURA - LIMA,4,LIMA,HUAURA,,5,8,6,SI,2,12,MUNICIPAL PROVINCIAL
1763,6794,JUNTOS POR EL PERU,1,16,QUISPICANCHI - CUSCO,1264,CUSCO,QUISPICANCHI,,5,9,7,SI,6,10,MUNICIPAL PROVINCIAL
1764,16425,MOVIMIENTO REGIONAL REVALORA,1,8,CONDESUYOS - AREQUIPA,2719,AREQUIPA,CONDESUYOS,,5,4,4,SI,2,6,MUNICIPAL PROVINCIAL
1765,16548,PARTIDO POLITICO NACIONAL PERU LIBRE,1,10,PARURO - CUSCO,2218,CUSCO,PARURO,,5,6,4,SI,2,8,MUNICIPAL PROVINCIAL
1766,16568,GESTIONANDO OBRAS Y OPORTUNIDADES CON LIDERAZGO,2,12,YUNGUYO - PUNO,2667,PUNO,YUNGUYO,,5,7,5,SI,4,8,MUNICIPAL PROVINCIAL
1767,16286,MOVIMIENTO REGIONAL INKA PACHAKUTEQ,1,19,CANCHIS - CUSCO,2368,CUSCO,CANCHIS,,5,10,9,SI,7,12,MUNICIPAL PROVINCIAL
1768,16609,ALIANZA PARA EL PROGRESO,1,19,CHUPACA - JUNIN,1257,JUNIN,CHUPACA,,5,10,9,SI,9,10,MUNICIPAL PROVINCIAL
1769,16576,TODOS POR EL GRAN CAMBIO,1,16,HUANUCO - HUANUCO,2712,HUANUCO,HUANUCO,,5,7,9,SI,2,14,MUNICIPAL PROVINCIAL
1770,16591,PARTIDO POLITICO NACIONAL PERU LIBRE,1,8,YAUYOS - LIMA,2218,LIMA,YAUYOS,,5,4,4,SI,2,6,MUNICIPAL PROVINCIAL
1771,15366,PARTIDO DEMOCRATICO SOMOS PERU,1,18,LA MAR - AYACUCHO,14,AYACUCHO,LA MAR,,5,10,8,SI,8,10,MUNICIPAL PROVINCIAL
1772,11827,PARTIDO POLITICO NACIONAL PERU LIBRE,1,12,ALTO AMAZONAS - LORETO,2218,LORETO,ALTO AMAZONAS,,5,7,5,NO,0,12,MUNICIPAL PROVINCIAL
1773,16605,PODER ANDINO,1,8,LAMPA - PUNO,2338,PUNO,LAMPA,,5,4,4,NO,0,8,MUNICIPAL PROVINCIAL
1774,16595,MOVIMIENTO REGIONAL AMAZONENSE UNIDOS AL CAMPO,1,13,CONDORCANQUI - AMAZONAS,40,AMAZONAS,CONDORCANQUI,,5,7,6,SI,5,8,MUNICIPAL PROVINCIAL
1775,15844,PARTIDO MORADO,1,19,HUANCAYO - JUNIN,2840,JUNIN,HUANCAYO,,5,10,9,SI,3,16,MUNICIPAL PROVINCIAL
1776,16599,AREQUIPA RENACE,2,20,AREQUIPA - AREQUIPA,443,AREQUIPA,AREQUIPA,,5,11,9,SI,4,16,MUNICIPAL PROVINCIAL
1777,8955,POR LAS COMUNIDADES FUENTE DE INTEGRACION ANDINA DE PUNO - CONFIA - PUNO,1,19,AZANGARO - PUNO,2230,PUNO,AZANGARO,,5,10,9,SI,7,12,MUNICIPAL PROVINCIAL
1778,8341,JUNTOS POR EL PERU,1,11,TARMA - JUNIN,1264,JUNIN,TARMA,,5,6,5,SI,1,10,MUNICIPAL PROVINCIAL
1779,12738,PARTIDO POLITICO NACIONAL PERU LIBRE,1,13,CHUCUITO - PUNO,2218,PUNO,CHUCUITO,,5,7,6,SI,3,10,MUNICIPAL PROVINCIAL
1780,16584,FUERZA CALLAO SEGURO,1,19,CALLAO - CALLAO,2766,CALLAO,CALLAO,,5,9,10,SI,3,16,MUNICIPAL PROVINCIAL
1781,16601,PARTIDO POLITICO NACIONAL PERU LIBRE,1,10,CONCEPCION - JUNIN,2218,JUNIN,CONCEPCION,,5,6,4,NO,0,10,MUNICIPAL PROVINCIAL
1782,16619,MORAL Y DESARROLLO,1,10,YUNGUYO - PUNO,292,PUNO,YUNGUYO,,5,6,4,SI,2,8,MUNICIPAL PROVINCIAL
1783,16590,MOVIMIENTO INDEPENDIENTE REGIONAL ANCASH A LA OBRA,1,14,SANTA - ANCASH,2687,ANCASH,SANTA,,5,7,7,NO,0,14,MUNICIPAL PROVINCIAL
1784,15119,AVANZA PAIS - PARTIDO DE INTEGRACION SOCIAL,1,12,BARRANCA - LIMA,2173,LIMA,BARRANCA,,5,6,6,NO,0,12,MUNICIPAL PROVINCIAL
1785,12125,ALIADOS POR EL CAMBIO JUNIN,1,17,HUANCAYO - JUNIN,2879,JUNIN,HUANCAYO,,5,8,9,SI,1,16,MUNICIPAL PROVINCIAL
1786,12586,MOVIMIENTO REGIONAL BLOQUE POPULAR JUNIN,1,14,CHANCHAMAYO - JUNIN,2169,JUNIN,CHANCHAMAYO,,5,7,7,SI,2,12,MUNICIPAL PROVINCIAL
1787,16611,PARTIDO POLITICO NACIONAL PERU LIBRE,1,17,ICA - ICA,2218,ICA,ICA,,5,9,8,SI,3,14,MUNICIPAL PROVINCIAL
1788,16387,ALIANZA PARA EL PROGRESO,1,17,FERREÑAFE - LAMBAYEQUE,1257,LAMBAYEQUE,FERREÑAFE,,5,9,8,SI,5,12,MUNICIPAL PROVINCIAL
1789,16045,AVANZA PAIS - PARTIDO DE INTEGRACION SOCIAL,1,18,HUANCAYO - JUNIN,2173,JUNIN,HUANCAYO,,5,10,8,SI,2,16,MUNICIPAL PROVINCIAL
1790,16635,MOVIMIENTO INDEPENDIENTE TRABAJANDO PARA TODOS,1,8,HUAYTARA - HUANCAVELICA,226,HUANCAVELICA,HUAYTARA,,5,4,4,SI,2,6,MUNICIPAL PROVINCIAL
1791,16428,ALIANZA PARA EL PROGRESO,1,22,CHICLAYO - LAMBAYEQUE,1257,LAMBAYEQUE,CHICLAYO,,5,12,10,SI,6,16,MUNICIPAL PROVINCIAL
1792,16600,PARTIDO DEMOCRATICO SOMOS PERU,1,8,MANU - MADRE DE DIOS,14,MADRE DE DIOS,MANU,,5,5,3,SI,2,6,MUNICIPAL PROVINCIAL
1793,15465,AVANZADA REGIONAL INDEPENDIENTE UNIDOS POR HUANUCO,1,12,LEONCIO PRADO - HUANUCO,2201,HUANUCO,LEONCIO PRADO,,5,7,5,NO,0,12,MUNICIPAL PROVINCIAL
1794,16628,PARTIDO POLITICO NACIONAL PERU LIBRE,1,12,CALCA - CUSCO,2218,CUSCO,CALCA,,5,7,5,SI,2,10,MUNICIPAL PROVINCIAL
1795,16552,MOVIMIENTO REGIONAL AGUA,1,15,ACOBAMBA - HUANCAVELICA,2681,HUANCAVELICA,ACOBAMBA,,5,8,7,SI,7,8,MUNICIPAL PROVINCIAL
1796,16683,ALIANZA PARA EL PROGRESO,1,15,PUNO - PUNO,1257,PUNO,PUNO,,5,8,7,SI,3,12,MUNICIPAL PROVINCIAL
1797,16295,PODER ANDINO,1,18,PUNO - PUNO,2338,PUNO,PUNO,,5,10,8,SI,6,12,MUNICIPAL PROVINCIAL
1798,15409,PARTIDO POLITICO NACIONAL PERU LIBRE,1,10,OTUZCO - LA LIBERTAD,2218,LA LIBERTAD,OTUZCO,,5,5,5,NO,0,10,MUNICIPAL PROVINCIAL
1799,16642,PARTIDO DEMOCRATICO SOMOS PERU,1,12,TAYACAJA - HUANCAVELICA,14,HUANCAVELICA,TAYACAJA,,5,6,6,SI,2,10,MUNICIPAL PROVINCIAL
1800,16675,MOVIMIENTO INDEPENDIENTE REGIONAL ANCASH A LA OBRA,1,8,CARHUAZ - ANCASH,2687,ANCASH,CARHUAZ,,5,4,4,NO,0,8,MUNICIPAL PROVINCIAL
1801,7845,GESTIONANDO OBRAS Y OPORTUNIDADES CON LIDERAZGO,2,11,EL COLLAO - PUNO,2667,PUNO,EL COLLAO,,5,6,5,SI,1,10,MUNICIPAL PROVINCIAL
1802,16681,SOCIOS POR ANCASH,1,10,HUAYLAS - ANCASH,2881,ANCASH,HUAYLAS,,5,5,5,NO,0,10,MUNICIPAL PROVINCIAL
1803,16666,MORAL Y DESARROLLO,1,10,EL COLLAO - PUNO,292,PUNO,EL COLLAO,,5,6,4,NO,0,10,MUNICIPAL PROVINCIAL
1804,16724,ALIANZA PARA EL PROGRESO,1,10,LAURICOCHA - HUANUCO,1257,HUANUCO,LAURICOCHA,,5,6,4,SI,4,6,MUNICIPAL PROVINCIAL
1805,11914,MOVIMIENTO REGIONAL GANA AYACUCHO,1,17,HUAMANGA - AYACUCHO,2694,AYACUCHO,HUAMANGA,,5,9,8,SI,5,12,MUNICIPAL PROVINCIAL
1806,16641,PARTIDO DEMOCRATICO SOMOS PERU,1,14,VIRU - LA LIBERTAD,14,LA LIBERTAD,VIRU,,5,7,7,SI,4,10,MUNICIPAL PROVINCIAL
1807,13722,AVANZADA REGIONAL INDEPENDIENTE UNIDOS POR HUANUCO,1,18,HUANUCO - HUANUCO,2201,HUANUCO,HUANUCO,,5,10,8,SI,4,14,MUNICIPAL PROVINCIAL
1808,15588,FE EN EL PERU,1,6,CANTA - LIMA,2898,LIMA,CANTA,,5,3,3,NO,0,6,MUNICIPAL PROVINCIAL
1809,16721,PARTIDO DEMOCRATICO SOMOS PERU,1,6,CASTROVIRREYNA - HUANCAVELICA,14,HUANCAVELICA,CASTROVIRREYNA,,5,3,3,NO,0,6,MUNICIPAL PROVINCIAL
1810,1830,PARTIDO POLITICO NACIONAL PERU LIBRE,1,40,LIMA - LIMA,2218,LIMA,LIMA,,5,20,20,NO,0,40,MUNICIPAL PROVINCIAL
1811,16446,ALIANZA PARA EL PROGRESO,1,22,LAMBAYEQUE - LAMBAYEQUE,1257,LAMBAYEQUE,LAMBAYEQUE,,5,11,11,SI,8,14,MUNICIPAL PROVINCIAL
1812,4727,PARTIDO POLITICO NACIONAL PERU LIBRE,1,6,OYON - LIMA,2218,LIMA,OYON,,5,4,2,NO,0,6,MUNICIPAL PROVINCIAL
1813,15450,PARTIDO DEMOCRATICO SOMOS PERU,1,6,VICTOR FAJARDO - AYACUCHO,14,AYACUCHO,VICTOR FAJARDO,,5,3,3,NO,0,6,MUNICIPAL PROVINCIAL
1814,13710,VAMOS MOQUEGUA,2,16,MARISCAL NIETO - MOQUEGUA,2917,MOQUEGUA,MARISCAL NIETO,,5,9,7,SI,6,10,MUNICIPAL PROVINCIAL
1815,16478,AVANZA PAIS - PARTIDO DE INTEGRACION SOCIAL,1,15,CHANCHAMAYO - JUNIN,2173,JUNIN,CHANCHAMAYO,,5,8,7,SI,3,12,MUNICIPAL PROVINCIAL
1816,16651,FRENTE POPULAR AGRICOLA FIA DEL PERU,1,21,AREQUIPA - AREQUIPA,2901,AREQUIPA,AREQUIPA,,5,11,10,SI,5,16,MUNICIPAL PROVINCIAL
1817,6513,FUERZA POPULAR,1,8,PICOTA - SAN MARTIN,1366,SAN MARTIN,PICOTA,,5,4,4,NO,0,8,MUNICIPAL PROVINCIAL
1818,16679,PARTIDO POLITICO NACIONAL PERU LIBRE,1,8,PAUCAR DEL SARA SARA - AYACUCHO,2218,AYACUCHO,PAUCAR DEL SARA SARA,,5,5,3,SI,2,6,MUNICIPAL PROVINCIAL
1819,6520,FUERZA POPULAR,1,12,MOYOBAMBA - SAN MARTIN,1366,SAN MARTIN,MOYOBAMBA,,5,7,5,NO,0,12,MUNICIPAL PROVINCIAL
1820,15934,PARTIDO POLITICO NACIONAL PERU LIBRE,1,13,SANTIAGO DE CHUCO - LA LIBERTAD,2218,LA LIBERTAD,SANTIAGO DE CHUCO,,5,7,6,SI,3,10,MUNICIPAL PROVINCIAL
1821,6532,FUERZA POPULAR,1,12,SAN MARTIN - SAN MARTIN,1366,SAN MARTIN,SAN MARTIN,,5,7,5,NO,0,12,MUNICIPAL PROVINCIAL
1822,8634,ACCION POPULAR,1,18,CAJAMARCA - CAJAMARCA,4,CAJAMARCA,CAJAMARCA,,5,10,8,SI,4,14,MUNICIPAL PROVINCIAL
1823,7066,FRENTE AMPLIO PARA EL DESARROLLO DEL PUEBLO,1,10,SAN ANTONIO DE PUTINA - PUNO,1670,PUNO,SAN ANTONIO DE PUTINA,,5,6,4,SI,2,8,MUNICIPAL PROVINCIAL
1824,16762,ALIANZA PARA EL PROGRESO,1,10,HUACAYBAMBA - HUANUCO,1257,HUANUCO,HUACAYBAMBA,,5,5,5,SI,4,6,MUNICIPAL PROVINCIAL
1825,16713,MOVIMIENTO INDEPENDIENTE REGIONAL ANCASH A LA OBRA,1,9,SIHUAS - ANCASH,2687,ANCASH,SIHUAS,,5,5,4,SI,1,8,MUNICIPAL PROVINCIAL
1826,16604,PARTIDO POLITICO NACIONAL PERU LIBRE,1,16,ESPINAR - CUSCO,2218,CUSCO,ESPINAR,,5,7,9,SI,6,10,MUNICIPAL PROVINCIAL
1827,16688,PARTIDO POLITICO NACIONAL PERU LIBRE,1,14,LEONCIO PRADO - HUANUCO,2218,HUANUCO,LEONCIO PRADO,,5,8,6,SI,2,12,MUNICIPAL PROVINCIAL
1828,16673,PODER ANDINO,1,21,SAN ROMAN - PUNO,2338,PUNO,SAN ROMAN,,5,11,10,SI,7,14,MUNICIPAL PROVINCIAL
1829,16716,MOVIMIENTO INDEPENDIENTE REGIONAL ANCASH A LA OBRA,1,10,YUNGAY - ANCASH,2687,ANCASH,YUNGAY,,5,5,5,NO,0,10,MUNICIPAL PROVINCIAL
1830,16545,MOVIMIENTO ACCION REGIONAL,1,13,EL COLLAO - PUNO,2866,PUNO,EL COLLAO,,5,7,6,SI,3,10,MUNICIPAL PROVINCIAL
1831,12298,MOVIMIENTO REGIONAL AGUA,1,20,TAYACAJA - HUANCAVELICA,2681,HUANCAVELICA,TAYACAJA,,5,11,9,SI,10,10,MUNICIPAL PROVINCIAL
1832,16759,PARTIDO FRENTE DE LA ESPERANZA 2021,1,12,CHANCHAMAYO - JUNIN,2857,JUNIN,CHANCHAMAYO,,5,6,6,NO,0,12,MUNICIPAL PROVINCIAL
1833,16677,PARTIDO POLITICO NACIONAL PERU LIBRE,1,17,AZANGARO - PUNO,2218,PUNO,AZANGARO,,5,9,8,SI,5,12,MUNICIPAL PROVINCIAL
1834,16705,MOVIMIENTO INDEPENDIENTE REGIONAL ANCASH A LA OBRA,1,6,RECUAY - ANCASH,2687,ANCASH,RECUAY,,5,3,3,NO,0,6,MUNICIPAL PROVINCIAL
1835,3168,ALIADOS POR EL CAMBIO JUNIN,1,12,SATIPO - JUNIN,2879,JUNIN,SATIPO,,5,7,5,NO,0,12,MUNICIPAL PROVINCIAL
1836,16528,PARTIDO POLITICO NACIONAL PERU LIBRE,1,8,SAN ANTONIO DE PUTINA - PUNO,2218,PUNO,SAN ANTONIO DE PUTINA,,5,5,3,NO,0,8,MUNICIPAL PROVINCIAL
1837,10340,FUERZA POPULAR,1,11,PURUS - UCAYALI,1366,UCAYALI,PURUS,,5,6,5,SI,5,6,MUNICIPAL PROVINCIAL
1838,16817,ALIANZA PARA EL PROGRESO,1,10,JUNIN - JUNIN,1257,JUNIN,JUNIN,,5,6,4,SI,4,6,MUNICIPAL PROVINCIAL
1839,16400,ALIANZA PARA EL PROGRESO,1,20,CAYLLOMA - AREQUIPA,1257,AREQUIPA,CAYLLOMA,,5,11,9,SI,10,10,MUNICIPAL PROVINCIAL
1840,16718,GESTIONANDO OBRAS Y OPORTUNIDADES CON LIDERAZGO,2,12,AZANGARO - PUNO,2667,PUNO,AZANGARO,,5,7,5,NO,0,12,MUNICIPAL PROVINCIAL
1841,16789,FRENTE AMPLIO PARA EL DESARROLLO DEL PUEBLO,1,15,AZANGARO - PUNO,1670,PUNO,AZANGARO,,5,8,7,SI,3,12,MUNICIPAL PROVINCIAL
1842,16826,ALIANZA PARA EL PROGRESO,1,16,CHANCHAMAYO - JUNIN,1257,JUNIN,CHANCHAMAYO,,5,9,7,SI,4,12,MUNICIPAL PROVINCIAL
1843,14047,REFORMA Y HONRADEZ POR MAS OBRAS,1,10,SAN ANTONIO DE PUTINA - PUNO,2912,PUNO,SAN ANTONIO DE PUTINA,,5,6,4,SI,2,8,MUNICIPAL PROVINCIAL
1844,16773,PARTIDO POLITICO NACIONAL PERU LIBRE,1,13,PATAZ - LA LIBERTAD,2218,LA LIBERTAD,PATAZ,,5,7,6,SI,3,10,MUNICIPAL PROVINCIAL
1845,16806,FRENTE POPULAR AGRICOLA FIA DEL PERU,1,18,CAJAMARCA - CAJAMARCA,2901,CAJAMARCA,CAJAMARCA,,5,9,9,SI,4,14,MUNICIPAL PROVINCIAL
1846,5777,ACCION POPULAR,1,10,SAN MARCOS - CAJAMARCA,4,CAJAMARCA,SAN MARCOS,,5,6,4,NO,0,10,MUNICIPAL PROVINCIAL
1847,16766,PARTIDO DEMOCRATICO SOMOS PERU,1,12,HUAMANGA - AYACUCHO,14,AYACUCHO,HUAMANGA,,5,6,6,NO,0,12,MUNICIPAL PROVINCIAL
1848,16786,POR LAS COMUNIDADES FUENTE DE INTEGRACION ANDINA DE PUNO - CONFIA - PUNO,1,11,LAMPA - PUNO,2230,PUNO,LAMPA,,5,6,5,SI,3,8,MUNICIPAL PROVINCIAL
1849,16798,PARTIDO POLITICO NACIONAL PERU LIBRE,1,12,CHINCHA - ICA,2218,ICA,CHINCHA,,5,7,5,NO,0,12,MUNICIPAL PROVINCIAL
1850,11340,ALIANZA PARA EL PROGRESO,1,8,CONTRALMIRANTE VILLAR - TUMBES,1257,TUMBES,CONTRALMIRANTE VILLAR,,5,4,4,SI,2,6,MUNICIPAL PROVINCIAL
1851,12895,JUNTOS POR EL PERU,1,12,CHANCHAMAYO - JUNIN,1264,JUNIN,CHANCHAMAYO,,5,5,7,NO,0,12,MUNICIPAL PROVINCIAL
1852,16787,FRENTE AMPLIO PARA EL DESARROLLO DEL PUEBLO,1,10,MELGAR - PUNO,1670,PUNO,MELGAR,,5,5,5,NO,0,10,MUNICIPAL PROVINCIAL
1853,16839,FRENTE POPULAR AGRICOLA FIA DEL PERU,1,10,CAYLLOMA - AREQUIPA,2901,AREQUIPA,CAYLLOMA,,5,5,5,NO,0,10,MUNICIPAL PROVINCIAL
1854,11353,ALIANZA PARA EL PROGRESO,1,18,ZARUMILLA - TUMBES,1257,TUMBES,ZARUMILLA,,5,10,8,SI,8,10,MUNICIPAL PROVINCIAL
1855,16852,ALIANZA PARA EL PROGRESO,1,23,HUANCAYO - JUNIN,1257,JUNIN,HUANCAYO,,5,12,11,SI,7,16,MUNICIPAL PROVINCIAL
1856,16856,ALIANZA PARA EL PROGRESO,1,6,HUAYTARA - HUANCAVELICA,1257,HUANCAVELICA,HUAYTARA,,5,3,3,NO,0,6,MUNICIPAL PROVINCIAL
